Año	Código del municipio	Nombre del municipio	Personas que son mano de obra familiar	Personas que son mano de obra familiar hombres	Personas que son mano de obra familiar mujeres	Personas que son mano de obra familiar <35 años	Personas que son mano de obra familiar de 35 a 45 años	Personas que son mano de obra familiar de 55 a 64 años	Personas que son mano de obra familiar de más de 65 años
1989	22001	Abiego	124	85	39	23	56	32	13
1989	22002	Abizanda	53	46	7	8	23	12	10
1989	22003	Adahuesca	69	67	2	7	23	20	19
1989	22004	Agüero	62	52	10	4	10	18	30
1989	22006	Aísa	63	46	17	5	22	19	17
1989	22007	Albalate de Cinca	448	349	99	101	156	107	84
1989	22008	Albalatillo	24	20	4	2	10	2	10
1989	22009	Albelda	595	411	184	161	221	143	70
1989	22011	Albero Alto	29	27	2	3	12	11	3
1989	22012	Albero Bajo	53	44	9	13	22	13	5
1989	22013	Alberuela de Tubo	102	89	13	28	40	17	17
1989	22014	Alcalá de Gurrea	39	37	2	11	17	5	6
1989	22015	Alcalá del Obispo	108	96	12	10	41	23	34
1989	22016	Alcampell	426	294	132	68	156	123	79
1989	22017	Alcolea de Cinca	373	322	51	57	132	115	69
1989	22018	Alcubierre	148	121	27	17	50	46	35
1989	22019	Alerre	17	16	1	2	6	7	2
1989	22020	Alfántega	44	34	10	12	20	5	7
1989	22021	Almudévar	622	553	69	93	245	180	104
1989	22022	Almunia de San Juan	124	108	16	14	43	35	32
1989	22023	Almuniente	149	140	9	37	75	21	16
1989	22024	Alquézar	112	100	12	15	29	36	32
1989	22025	Altorricón	531	363	168	123	208	127	73
1989	22027	Angüés	127	123	4	10	38	35	44
1989	22028	Ansó	33	29	4	1	17	13	2
1989	22029	Antillón	48	42	6	6	22	13	7
1989	22032	Aragüés del Puerto	38	34	4	6	8	18	6
1989	22035	Arén	108	90	18	17	34	40	17
1989	22036	Argavieso	45	42	3	5	17	13	10
1989	22037	Arguis	16	14	2	0	6	6	4
1989	22039	Ayerbe	245	223	22	19	71	75	80
1989	22040	Azanuy-Alins	100	87	13	7	33	32	28
1989	22041	Azara	85	57	28	14	32	22	17
1989	22042	Azlor	73	55	18	16	24	19	14
1989	22043	Baells	59	50	9	5	36	9	9
1989	22044	Bailo	107	86	21	14	38	29	26
1989	22045	Baldellou	84	74	10	8	25	23	28
1989	22046	Ballobar	336	254	82	91	117	84	44
1989	22047	Banastás	6	5	1	0	3	2	1
1989	22048	Barbastro	819	667	152	95	285	238	201
1989	22049	Barbués	53	50	3	17	19	13	4
1989	22050	Barbuñales	35	34	1	3	13	12	7
1989	22051	Bárcabo	58	47	11	14	18	20	6
1989	22052	Belver de Cinca	399	344	55	109	149	93	48
1989	22053	Benabarre	298	235	63	48	124	63	63
1989	22054	Benasque	70	57	13	5	20	20	25
1989	22055	Berbegal	119	93	26	18	55	33	13
1989	22057	Bielsa	116	91	25	10	35	41	30
1989	22058	Bierge	193	144	49	20	46	53	74
1989	22059	Biescas	344	213	131	46	91	111	96
1989	22060	Binaced	529	361	168	140	191	113	85
1989	22061	Binéfar	244	194	50	32	100	83	29
1989	22062	Bisaurri	86	63	23	13	34	23	16
1989	22063	Biscarrués	74	69	5	9	23	22	20
1989	22064	Blecua y Torres	64	62	2	13	25	12	14
1989	22066	Boltaña	97	78	19	12	22	24	39
1989	22067	Bonansa	30	19	11	8	11	7	4
1989	22068	Borau	31	20	11	4	10	8	9
1989	22069	Broto	191	157	34	32	51	83	25
1989	22072	Caldearenas	78	70	8	16	27	18	17
1989	22074	Campo	40	34	6	5	12	9	14
1989	22075	Camporrells	156	117	39	16	47	39	54
1989	22076	Canal de Berdún	147	127	20	23	38	53	33
1989	22077	Candasnos	110	101	9	26	53	21	10
1989	22078	Canfranc	5	3	2	0	2	1	2
1989	22079	Capdesaso	56	50	6	11	20	17	8
1989	22080	Capella	175	138	37	16	60	47	52
1989	22081	Casbas de Huesca	185	146	39	28	77	42	38
1989	22082	Castejón del Puente	86	75	11	14	33	20	19
1989	22083	Castejón de Monegros	199	179	20	33	68	46	52
1989	22084	Castejón de Sos	70	54	16	4	24	15	27
1989	22085	Castelflorite	64	55	9	11	33	13	7
1989	22086	Castiello de Jaca	42	24	18	6	10	12	14
1989	22087	Castigaleu	33	26	7	7	16	8	2
1989	22088	Castillazuelo	96	92	4	7	21	18	50
1989	22089	Castillonroy	212	140	72	61	79	41	31
1989	22090	Colungo	94	76	18	12	30	21	31
1989	22094	Chalamera	72	54	18	23	23	21	5
1989	22095	Chía	37	30	7	6	13	12	6
1989	22096	Chimillas	19	18	1	0	9	8	2
1989	22099	Esplús	197	167	30	35	67	57	38
1989	22102	Estada	67	60	7	8	19	13	27
1989	22103	Estadilla	259	219	40	46	108	69	36
1989	22105	Estopiñán del Castillo	114	92	22	14	36	33	31
1989	22106	Fago	11	8	3	1	4	4	2
1989	22107	Fanlo	23	20	3	5	6	5	7
1989	22109	Fiscal	91	79	12	10	28	24	29
1989	22110	Fonz	258	243	15	47	91	71	49
1989	22111	Foradada del Toscar	99	69	30	21	42	21	15
1989	22112	Fraga	2110	1439	671	509	881	483	237
1989	22113	Fueva (La)	314	241	73	63	109	70	72
1989	22114	Gistaín	105	77	28	12	36	32	25
1989	22115	Grado (El)	257	211	46	35	68	74	80
1989	22116	Grañén	333	293	40	92	114	95	32
1989	22117	Graus	622	464	158	93	192	161	176
1989	22119	Gurrea de Gállego	368	334	34	88	168	89	23
1989	22122	Hoz de Jaca	28	19	9	3	6	9	10
1989	22124	Huerto	110	96	14	22	46	27	15
1989	22125	Huesca	283	260	23	43	96	86	58
1989	22126	Ibieca	41	40	1	7	11	9	14
1989	22127	Igriés	35	34	1	7	11	12	5
1989	22128	Ilche	99	86	13	18	37	30	14
1989	22129	Isábena	102	72	30	15	38	22	27
1989	22130	Jaca	418	348	70	60	138	137	83
1989	22131	Jasa	22	17	5	3	8	6	5
1989	22133	Labuerda	47	44	3	2	11	8	26
1989	22135	Laluenga	103	93	10	24	32	30	17
1989	22136	Lalueza	400	332	68	78	166	101	55
1989	22137	Lanaja	355	310	45	66	121	113	55
1989	22139	Laperdiguera	31	29	2	8	11	7	5
1989	22141	Lascellas-Ponzano	55	53	2	10	18	20	7
1989	22142	Lascuarre	63	49	14	16	22	16	9
1989	22143	Laspaúles	98	69	29	16	38	27	17
1989	22144	Laspuña	92	64	28	6	32	35	19
1989	22149	Loarre	126	121	5	6	52	38	30
1989	22150	Loporzano	219	191	28	23	76	67	53
1989	22151	Loscorrales	49	43	6	4	15	16	14
1989	22155	Monesma y Cajigar	60	38	22	22	19	15	4
1989	22156	Monflorite-Lascasas	62	55	7	10	25	21	6
1989	22157	Montanuy	147	108	39	41	46	45	15
1989	22158	Monzón	956	840	116	131	341	280	204
1989	22160	Naval	103	81	22	11	29	19	44
1989	22162	Novales	40	37	3	8	9	13	10
1989	22163	Nueno	99	88	11	12	31	25	31
1989	22164	Olvena	36	29	7	5	14	9	8
1989	22165	Ontiñena	145	138	7	28	48	43	26
1989	22167	Osso de Cinca	293	207	86	91	114	54	34
1989	22168	Palo	32	31	1	2	10	5	15
1989	22170	Panticosa	72	59	13	7	21	22	22
1989	22172	Peñalba	138	122	16	24	42	54	18
1989	22173	Peñas de Riglos (Las)	88	77	11	9	24	30	25
1989	22174	Peralta de Alcofea	157	121	36	31	69	42	15
1989	22175	Peralta de Calasanz	278	209	69	24	85	70	99
1989	22176	Peraltilla	50	45	5	7	22	12	9
1989	22177	Perarrúa	81	55	26	8	31	21	21
1989	22178	Pertusa	34	33	1	9	18	4	3
1989	22181	Piracés	26	25	1	10	8	6	2
1989	22182	Plan	110	78	32	13	37	29	31
1989	22184	Poleñino	67	60	7	17	30	16	4
1989	22186	Pozán de Vero	105	97	8	10	34	20	41
1989	22187	Puebla de Castro (La)	114	81	33	9	34	29	42
1989	22188	Puente de Montañana	37	26	11	5	13	10	9
1989	22189	Puértolas	76	61	15	6	24	18	28
1989	22190	Pueyo de Araguás (El)	64	59	5	9	25	17	13
1989	22193	Pueyo de Santa Cruz	86	72	14	6	34	24	22
1989	22195	Quicena	13	12	1	1	4	6	2
1989	22197	Robres	145	137	8	36	51	44	14
1989	22199	Sabiñánigo	344	300	44	39	103	93	109
1989	22200	Sahún	77	56	21	9	28	19	21
1989	22201	Salas Altas	258	191	67	59	86	52	61
1989	22202	Salas Bajas	117	87	30	18	33	29	37
1989	22203	Salillas	40	33	7	3	16	16	5
1989	22204	Sallent de Gállego	115	88	27	19	40	35	21
1989	22205	San Esteban de Litera	363	286	77	51	153	99	60
1989	22206	Sangarrén	86	78	8	12	34	21	19
1989	22207	San Juan de Plan	64	40	24	7	26	19	12
1989	22208	Santa Cilia	61	46	15	8	25	18	10
1989	22209	Santa Cruz de la Serós	46	35	11	5	15	16	10
1989	22212	Santaliestra y San Quílez	32	27	5	3	14	6	9
1989	22213	Sariñena	656	545	111	159	277	142	78
1989	22214	Secastilla	83	63	20	11	27	21	24
1989	22215	Seira	41	27	14	1	12	7	21
1989	22217	Sena	156	139	17	31	68	33	24
1989	22218	Senés de Alcubierre	28	24	4	7	15	5	1
1989	22220	Sesa	69	63	6	7	31	22	9
1989	22221	Sesué	29	21	8	4	10	9	6
1989	22222	Siétamo	112	109	3	17	32	26	37
1989	22223	Sopeira	36	26	10	4	7	13	12
1989	22225	Tamarite de Litera	1190	807	383	286	439	287	178
1989	22226	Tardienta	237	225	12	31	75	78	53
1989	22227	Tella-Sin	74	49	25	8	17	28	21
1989	22228	Tierz	26	23	3	6	7	8	5
1989	22229	Tolva	105	79	26	18	40	26	21
1989	22230	Torla-Ordesa	73	59	14	11	31	19	12
1989	22232	Torralba de Aragón	52	48	4	12	20	15	5
1989	22233	Torre la Ribera	43	30	13	10	16	12	5
1989	22234	Torrente de Cinca	192	132	60	44	76	44	28
1989	22235	Torres de Alcanadre	37	34	3	16	9	9	3
1989	22236	Torres de Barbués	67	59	8	21	28	11	7
1989	22239	Tramaced	43	35	8	8	19	13	3
1989	22242	Valfarta	31	26	5	2	12	10	7
1989	22243	Valle de Bardají	23	17	6	6	9	5	3
1989	22244	Valle de Lierp	28	19	9	8	9	8	3
1989	22245	Velilla de Cinca	121	84	37	23	45	31	22
1989	22246	Beranuy	61	43	18	11	18	16	16
1989	22247	Viacamp y Litera	34	30	4	5	9	9	11
1989	22248	Vicién	16	14	2	4	5	3	4
1989	22249	Villanova	10	9	1	1	6	2	1
1989	22250	Villanúa	30	22	8	1	6	14	9
1989	22251	Villanueva de Sigena	116	106	10	37	47	24	8
1989	22252	Yebra de Basa	37	35	2	8	10	10	9
1989	22253	Yésero	36	20	16	7	11	5	13
1989	22254	Zaidín	632	437	195	204	265	129	34
1989	22901	Valle de Hecho	281	231	50	47	90	74	70
1989	22902	Puente la Reina de Jaca	99	71	28	16	39	28	16
1989	22903	San Miguel del Cinca	426	323	103	99	154	95	78
1989	22904	Sotonera (La)	483	425	58	76	155	134	118
1989	22905	Lupiñén-Ortilla	116	92	24	12	44	28	32
1989	22906	Santa María de Dulcis	90	82	8	11	22	20	37
1989	22907	Aínsa-Sobrarbe	191	162	29	33	66	55	37
1989	22908	Hoz y Costeán	218	178	40	26	56	61	75
1989	22909	Vencillón	128	111	17	34	56	28	10
1989	44001	Ababuj	52	37	15	8	20	19	5
1989	44002	Abejuela	25	16	9	0	6	10	9
1989	44003	Aguatón	18	11	7	1	7	9	1
1989	44004	Aguaviva	220	160	60	18	60	79	63
1989	44005	Aguilar del Alfambra	52	33	19	4	17	19	12
1989	44006	Alacón	200	129	71	44	60	73	23
1989	44007	Alba	107	86	21	30	44	26	7
1989	44008	Albalate del Arzobispo	518	386	132	58	163	175	122
1989	44009	Albarracín	103	87	16	19	28	33	23
1989	44010	Albentosa	181	128	53	15	56	44	66
1989	44011	Alcaine	34	28	6	3	7	11	13
1989	44012	Alcalá de la Selva	200	150	50	9	60	59	72
1989	44013	Alcañiz	1414	993	421	221	580	416	197
1989	44014	Alcorisa	729	547	182	105	277	205	142
1989	44016	Alfambra	220	166	54	42	85	72	21
1989	44017	Aliaga	177	127	50	10	34	52	81
1989	44018	Almohaja	6	4	2	0	2	4	0
1989	44019	Alobras	70	41	29	14	9	17	30
1989	44020	Alpeñés	20	18	2	6	7	3	4
1989	44021	Allepuz	121	92	29	9	39	42	31
1989	44022	Alloza	249	187	62	28	87	65	69
1989	44023	Allueva	2	2	0	0	1	1	0
1989	44024	Anadón	13	6	7	3	6	4	0
1989	44025	Andorra	588	383	205	111	240	172	65
1989	44026	Arcos de las Salinas	85	50	35	10	25	25	25
1989	44027	Arens de Lledó	148	94	54	24	58	49	17
1989	44028	Argente	119	83	36	25	48	38	8
1989	44029	Ariño	266	190	76	35	79	84	68
1989	44031	Azaila	57	53	4	11	25	17	4
1989	44032	Bádenas	10	9	1	2	5	3	0
1989	44033	Báguena	363	245	118	52	120	99	92
1989	44034	Bañón	69	52	17	15	26	26	2
1989	44035	Barrachina	79	49	30	3	28	27	21
1989	44036	Bea	13	13	0	4	3	5	1
1989	44037	Beceite	214	171	43	26	81	60	47
1989	44038	Belmonte de San José	157	102	55	7	33	37	80
1989	44039	Bello	203	121	82	32	54	78	39
1989	44040	Berge	131	92	39	12	35	50	34
1989	44041	Bezas	22	14	8	0	5	6	11
1989	44042	Blancas	75	54	21	14	35	24	2
1989	44043	Blesa	70	54	16	10	27	28	5
1989	44044	Bordón	69	48	21	11	20	24	14
1989	44045	Bronchales	75	67	8	3	21	26	25
1989	44046	Bueña	61	46	15	11	23	23	4
1989	44047	Burbáguena	391	283	108	26	129	118	118
1989	44048	Cabra de Mora	63	43	20	6	26	18	13
1989	44049	Calaceite	616	383	233	103	226	168	119
1989	44050	Calamocha	1109	837	272	99	325	377	308
1989	44051	Calanda	626	458	168	139	207	198	82
1989	44052	Calomarde	27	21	6	0	7	11	9
1989	44053	Camañas	69	50	19	18	27	22	2
1989	44054	Camarena de la Sierra	221	137	84	2	44	50	125
1989	44055	Camarillas	77	54	23	4	31	19	23
1989	44056	Caminreal	187	152	35	26	81	63	17
1989	44059	Cantavieja	176	123	53	41	76	49	10
1989	44060	Cañada de Benatanduz	50	32	18	6	20	17	7
1989	44061	Cañada de Verich (La)	93	60	33	12	20	26	35
1989	44062	Cañada Vellida	31	29	2	4	17	8	2
1989	44063	Cañizar del Olivar	70	53	17	4	15	22	29
1989	44064	Cascante del Río	245	163	82	15	71	47	112
1989	44065	Castejón de Tornos	62	37	25	10	26	20	6
1989	44066	Castel de Cabra	71	55	16	12	19	26	14
1989	44067	Castelnou	37	29	8	5	14	14	4
1989	44068	Castelserás	254	171	83	40	84	61	69
1989	44070	Castellar (El)	59	39	20	6	25	22	6
1989	44071	Castellote	552	357	195	72	179	126	175
1989	44074	Cedrillas	193	145	48	26	77	56	34
1989	44075	Celadas	222	153	69	56	80	70	16
1989	44076	Cella	911	613	298	154	409	275	73
1989	44077	Cerollera (La)	54	44	10	1	15	18	20
1989	44080	Codoñera (La)	130	85	45	31	46	41	12
1989	44082	Corbalán	54	38	16	4	14	24	12
1989	44084	Cortes de Aragón	32	22	10	4	11	11	6
1989	44085	Cosa	49	36	13	11	24	12	2
1989	44086	Cretas	412	283	129	59	157	124	72
1989	44087	Crivillén	100	83	17	1	14	28	57
1989	44088	Cuba (La)	37	25	12	5	11	15	6
1989	44089	Cubla	145	93	52	8	28	38	71
1989	44090	Cucalón	17	14	3	1	11	5	0
1989	44092	Cuervo (El)	88	58	30	7	28	18	35
1989	44093	Cuevas de Almudén	41	34	7	13	11	10	7
1989	44094	Cuevas Labradas	68	46	22	9	30	20	9
1989	44096	Ejulve	364	232	132	19	86	90	169
1989	44097	Escorihuela	143	85	58	23	41	52	27
1989	44099	Escucha	110	88	22	19	22	29	40
1989	44100	Estercuel	133	105	28	3	22	33	75
1989	44101	Ferreruela de Huerva	30	26	4	3	9	17	1
1989	44102	Fonfría	21	14	7	3	8	10	0
1989	44103	Formiche Alto	74	46	28	3	24	26	21
1989	44105	Fórnoles	299	176	123	23	89	80	107
1989	44106	Fortanete	141	89	52	18	57	44	22
1989	44107	Foz-Calanda	122	80	42	33	43	33	13
1989	44108	Fresneda (La)	447	272	175	53	127	122	145
1989	44109	Frías de Albarracín	47	37	10	8	19	15	5
1989	44110	Fuenferrada	29	23	6	2	10	12	5
1989	44111	Fuentes Calientes	73	56	17	10	37	14	12
1989	44112	Fuentes Claras	208	161	47	16	89	76	27
1989	44113	Fuentes de Rubielos	85	57	28	10	11	23	41
1989	44114	Fuentespalda	209	143	66	25	93	52	39
1989	44115	Galve	77	53	24	11	30	25	11
1989	44116	Gargallo	101	73	28	1	17	22	61
1989	44117	Gea de Albarracín	156	115	41	20	40	53	43
1989	44118	Ginebrosa (La)	232	158	74	36	65	68	63
1989	44119	Griegos	37	30	7	3	22	9	3
1989	44120	Guadalaviar	65	56	9	16	22	19	8
1989	44121	Gúdar	77	51	26	8	29	22	18
1989	44122	Híjar	449	375	74	41	145	156	107
1989	44123	Hinojosa de Jarque	62	52	10	10	19	23	10
1989	44124	Hoz de la Vieja (La)	99	74	25	7	35	29	28
1989	44125	Huesa del Común	51	47	4	2	14	13	22
1989	44126	Iglesuela del Cid (La)	171	126	45	8	62	57	44
1989	44127	Jabaloyas	58	33	25	8	17	25	8
1989	44128	Jarque de la Val	44	34	10	8	16	14	6
1989	44129	Jatiel	11	9	2	2	2	4	3
1989	44130	Jorcas	32	21	11	2	16	9	5
1989	44131	Josa	59	58	1	0	11	23	25
1989	44132	Lagueruela	28	21	7	1	13	12	2
1989	44133	Lanzuela	19	16	3	2	6	7	4
1989	44135	Libros	177	117	60	15	49	58	55
1989	44136	Lidón	36	26	10	6	20	9	1
1989	44137	Linares de Mora	184	126	58	28	63	44	49
1989	44138	Loscos	69	54	15	8	32	24	5
1989	44141	Lledó	104	74	30	23	33	35	13
1989	44142	Maicas	32	26	6	0	3	5	24
1989	44143	Manzanera	258	185	73	20	71	69	98
1989	44144	Martín del Río	123	102	21	10	36	43	34
1989	44145	Mas de las Matas	186	147	39	7	66	69	44
1989	44146	Mata de los Olmos (La)	54	48	6	1	24	17	12
1989	44147	Mazaleón	402	288	114	83	146	109	64
1989	44148	Mezquita de Jarque	43	35	8	10	18	12	3
1989	44149	Mirambel	62	45	17	16	29	15	2
1989	44150	Miravete de la Sierra	53	39	14	4	14	8	27
1989	44151	Molinos	162	113	49	21	43	49	49
1989	44152	Monforte de Moyuela	43	34	9	4	18	16	5
1989	44153	Monreal del Campo	376	284	92	34	132	157	53
1989	44154	Monroyo	141	116	25	11	38	50	42
1989	44155	Montalbán	163	133	30	3	33	49	78
1989	44156	Monteagudo del Castillo	41	31	10	4	14	14	9
1989	44157	Monterde de Albarracín	29	18	11	5	15	6	3
1989	44158	Mora de Rubielos	330	245	85	15	101	94	120
1989	44159	Moscardón	32	22	10	7	7	16	2
1989	44160	Mosqueruela	332	221	111	32	123	103	74
1989	44161	Muniesa	253	174	79	50	90	95	18
1989	44163	Noguera de Albarracín	50	41	9	7	12	15	16
1989	44164	Nogueras	14	13	1	0	6	6	2
1989	44165	Nogueruelas	138	98	40	9	36	36	57
1989	44167	Obón	99	74	25	5	17	26	51
1989	44168	Odón	115	84	31	22	51	31	11
1989	44169	Ojos Negros	125	99	26	27	50	41	7
1989	44171	Olba	320	230	90	9	47	65	199
1989	44172	Oliete	354	237	117	42	101	105	106
1989	44173	Olmos (Los)	106	82	24	21	36	34	15
1989	44174	Orihuela del Tremedal	44	42	2	9	17	13	5
1989	44175	Orrios	91	65	26	16	36	28	11
1989	44176	Palomar de Arroyos	59	51	8	8	13	20	18
1989	44177	Pancrudo	81	73	8	6	25	32	18
1989	44178	Parras de Castellote (Las)	58	42	16	7	13	26	12
1989	44179	Peñarroya de Tastavins	285	185	100	43	94	87	61
1989	44180	Peracense	29	20	9	1	22	6	0
1989	44181	Peralejos	38	23	15	1	12	18	7
1989	44182	Perales del Alfambra	137	105	32	28	42	45	22
1989	44183	Pitarque	113	80	33	10	21	31	51
1989	44184	Plou	21	17	4	0	8	4	9
1989	44185	Pobo (El)	90	67	23	16	42	20	12
1989	44187	Portellada (La)	122	87	35	20	53	27	22
1989	44189	Pozondón	43	33	10	7	8	19	9
1989	44190	Pozuel del Campo	36	22	14	9	14	11	2
1989	44191	Puebla de Híjar (La)	163	139	24	26	60	61	16
1989	44192	Puebla de Valverde (La)	312	224	88	24	75	78	135
1989	44193	Puertomingalvo	146	96	50	9	51	41	45
1989	44194	Ráfales	102	76	26	14	42	33	13
1989	44195	Rillo	40	38	2	6	10	17	7
1989	44196	Riodeva	328	196	132	10	89	112	117
1989	44197	Ródenas	50	32	18	10	19	17	4
1989	44198	Royuela	47	45	2	2	26	10	9
1989	44199	Rubiales	52	37	15	6	11	16	19
1989	44200	Rubielos de la Cérida	27	22	5	3	9	11	4
1989	44201	Rubielos de Mora	293	209	84	21	94	99	79
1989	44203	Salcedillo	6	4	2	1	2	1	2
1989	44204	Saldón	36	23	13	7	8	6	15
1989	44205	Samper de Calanda	263	213	50	26	105	90	42
1989	44206	San Agustín	222	168	54	19	48	64	91
1989	44207	San Martín del Río	264	175	89	11	83	98	72
1989	44208	Santa Cruz de Nogueras	15	13	2	1	7	6	1
1989	44209	Santa Eulalia	182	146	36	33	71	63	15
1989	44210	Sarrión	298	252	46	22	113	89	74
1989	44211	Segura de los Baños	23	21	2	1	11	6	5
1989	44212	Seno	59	43	16	3	16	28	12
1989	44213	Singra	55	40	15	12	18	20	5
1989	44215	Terriente	100	61	39	12	28	38	22
1989	44216	Teruel	666	495	171	57	254	233	122
1989	44217	Toril y Masegoso	23	16	7	7	4	5	7
1989	44218	Tormón	23	14	9	0	8	8	7
1989	44219	Tornos	122	76	46	11	60	39	12
1989	44220	Torralba de los Sisones	112	63	49	13	42	41	16
1989	44221	Torrecilla de Alcañiz	180	105	75	37	65	62	16
1989	44222	Torrecilla del Rebollar	59	37	22	10	20	26	3
1989	44223	Torre de Arcas	30	27	3	3	11	13	3
1989	44224	Torre de las Arcas	29	22	7	3	3	10	13
1989	44225	Torre del Compte	188	109	79	24	78	51	35
1989	44226	Torrelacárcel	106	77	29	11	39	43	13
1989	44227	Torre los Negros	53	38	15	7	15	9	22
1989	44228	Torremocha de Jiloca	70	52	18	9	21	30	10
1989	44229	Torres de Albarracín	40	28	12	6	17	12	5
1989	44230	Torrevelilla	156	99	57	29	32	47	48
1989	44231	Torrijas	59	37	22	4	13	16	26
1989	44232	Torrijo del Campo	246	154	92	45	88	92	21
1989	44234	Tramacastiel	184	112	72	6	35	49	94
1989	44235	Tramacastilla	27	21	6	9	7	9	2
1989	44236	Tronchón	66	50	16	11	28	16	11
1989	44237	Urrea de Gaén	173	145	28	24	71	42	36
1989	44238	Utrillas	82	71	11	10	26	22	24
1989	44239	Valacloche	73	40	33	0	12	24	37
1989	44240	Valbona	130	88	42	9	49	29	43
1989	44241	Valdealgorfa	392	223	169	60	141	120	71
1989	44243	Valdecuenca	10	6	4	4	2	3	1
1989	44244	Valdelinares	79	54	25	12	23	25	19
1989	44245	Valdeltormo	66	42	24	10	35	11	10
1989	44246	Valderrobres	627	429	198	126	234	167	100
1989	44247	Valjunquera	250	148	102	43	97	68	42
1989	44249	Vallecillo (El)	12	8	4	0	3	3	6
1989	44250	Veguillas de la Sierra	14	11	3	2	2	8	2
1989	44251	Villafranca del Campo	131	101	30	25	57	36	13
1989	44252	Villahermosa del Campo	25	24	1	5	13	6	1
1989	44256	Villanueva del Rebollar de la Sierra	19	11	8	0	12	6	1
1989	44257	Villar del Cobo	65	55	10	10	27	17	11
1989	44258	Villar del Salz	52	46	6	4	18	13	17
1989	44260	Villarluengo	146	89	57	31	43	35	37
1989	44261	Villarquemado	364	279	85	86	145	94	39
1989	44262	Villarroya de los Pinares	87	68	19	10	19	26	32
1989	44263	Villastar	111	71	40	18	37	37	19
1989	44264	Villel	545	345	200	53	184	99	209
1989	44265	Vinaceite	102	86	16	17	45	34	6
1989	44266	Visiedo	94	63	31	13	46	30	5
1989	44267	Vivel del Río Martín	38	28	10	1	22	9	6
1989	44268	Zoma (La)	30	26	4	1	9	6	14
1989	50001	Abanto	44	44	0	4	15	17	8
1989	50002	Acered	243	154	89	31	90	71	51
1989	50003	Agón	96	83	13	31	33	22	10
1989	50004	Aguarón	328	234	94	39	123	97	69
1989	50005	Aguilón	154	123	31	12	40	61	41
1989	50006	Ainzón	455	387	68	116	135	109	95
1989	50007	Aladrén	113	84	29	5	44	34	30
1989	50008	Alagón	830	651	179	101	278	237	214
1989	50009	Alarba	192	118	74	57	71	41	23
1989	50010	Alberite de San Juan	25	21	4	5	13	2	5
1989	50011	Albeta	4	4	0	1	1	2	0
1989	50012	Alborge	11	8	3	0	3	3	5
1989	50013	Alcalá de Ebro	125	109	16	9	53	33	30
1989	50014	Alcalá de Moncayo	62	52	10	5	32	10	15
1989	50015	Alconchel de Ariza	107	70	37	26	55	25	1
1989	50016	Aldehuela de Liestos	17	17	0	1	7	8	1
1989	50017	Alfajarín	294	274	20	48	144	75	27
1989	50018	Alfamén	571	459	112	149	216	127	79
1989	50019	Alforque	53	36	17	6	15	13	19
1989	50020	Alhama de Aragón	117	103	14	5	42	32	38
1989	50021	Almochuel	18	13	5	3	9	4	2
1989	50022	Almolda (La)	268	240	28	39	95	73	61
1989	50023	Almonacid de la Cuba	212	138	74	44	78	72	18
1989	50024	Almonacid de la Sierra	445	374	71	81	171	102	91
1989	50025	Almunia de Doña Godina (La)	1473	1144	329	360	587	313	213
1989	50026	Alpartir	395	306	89	70	167	90	68
1989	50027	Ambel	266	215	51	35	100	59	72
1989	50028	Anento	21	18	3	3	8	7	3
1989	50029	Aniñón	448	304	144	52	214	117	65
1989	50030	Añón de Moncayo	135	118	17	15	34	45	41
1989	50031	Aranda de Moncayo	104	88	16	13	26	31	34
1989	50032	Arándiga	260	222	38	24	83	71	82
1989	50033	Ardisa	54	45	9	10	14	11	19
1989	50034	Ariza	269	228	41	21	63	73	112
1989	50035	Artieda	13	11	2	0	7	2	4
1989	50036	Asín	24	20	4	2	6	6	10
1989	50037	Atea	317	190	127	16	101	80	120
1989	50038	Ateca	686	527	159	134	263	130	159
1989	50039	Azuara	238	216	22	31	90	69	48
1989	50040	Badules	34	33	1	5	13	12	4
1989	50041	Bagüés	30	24	6	2	6	13	9
1989	50042	Balconchán	27	21	6	0	5	8	14
1989	50043	Bárboles	77	68	9	10	29	23	15
1989	50044	Bardallur	100	78	22	10	56	19	15
1989	50045	Belchite	535	441	94	33	181	157	164
1989	50046	Belmonte de Gracián	182	142	40	23	58	65	36
1989	50047	Berdejo	21	13	8	2	1	6	12
1989	50048	Berrueco	13	12	1	2	5	6	0
1989	50050	Bijuesca	101	83	18	6	40	24	31
1989	50051	Biota	399	355	44	63	150	97	89
1989	50052	Bisimbre	57	45	12	9	28	11	9
1989	50053	Boquiñeni	435	306	129	97	177	100	61
1989	50054	Bordalba	29	29	0	2	15	9	3
1989	50055	Borja	752	599	153	106	288	202	156
1989	50056	Botorrita	34	33	1	3	15	11	5
1989	50057	Brea de Aragón	253	184	69	44	92	68	49
1989	50058	Bubierca	53	46	7	4	9	17	23
1989	50059	Bujaraloz	228	211	17	47	75	79	27
1989	50060	Bulbuente	260	182	78	16	59	77	108
1989	50061	Bureta	101	86	15	8	60	19	14
1989	50062	Burgo de Ebro (El)	354	290	64	39	132	102	81
1989	50063	Buste (El)	42	30	12	11	14	5	12
1989	50064	Cabañas de Ebro	151	133	18	25	72	37	17
1989	50065	Cabolafuente	33	31	2	6	5	14	8
1989	50066	Cadrete	76	66	10	8	25	22	21
1989	50067	Calatayud	965	830	135	148	307	281	229
1989	50068	Calatorao	991	763	228	159	397	272	163
1989	50069	Calcena	49	43	6	1	13	7	28
1989	50070	Calmarza	29	29	0	1	16	6	6
1989	50071	Campillo de Aragón	85	78	7	17	32	29	7
1989	50072	Carenas	145	106	39	15	45	47	38
1989	50073	Cariñena	1005	786	219	234	366	201	204
1989	50074	Caspe	1510	1299	211	236	578	403	293
1989	50075	Castejón de Alarba	98	65	33	14	32	38	14
1989	50076	Castejón de las Armas	90	74	16	2	25	25	38
1989	50077	Castejón de Valdejasa	204	172	32	21	74	65	44
1989	50078	Castiliscar	149	125	24	13	50	42	44
1989	50079	Cervera de la Cañada	194	148	46	19	74	59	42
1989	50080	Cerveruela	2	2	0	1	0	1	0
1989	50081	Cetina	240	208	32	26	75	77	62
1989	50082	Cimballa	47	41	6	5	17	15	10
1989	50083	Cinco Olivas	7	7	0	3	0	2	2
1989	50084	Clarés de Ribota	96	80	16	4	31	34	27
1989	50085	Codo	22	20	2	1	13	4	4
1989	50086	Codos	360	249	111	39	137	100	84
1989	50087	Contamina	29	25	4	1	5	6	17
1989	50088	Cosuenda	407	290	117	85	152	78	92
1989	50089	Cuarte de Huerva	30	24	6	2	9	9	10
1989	50090	Cubel	62	58	4	17	29	13	3
1989	50091	Cuerlas (Las)	27	26	1	4	5	16	2
1989	50092	Chiprana	58	41	17	13	23	13	9
1989	50093	Chodes	117	101	16	13	43	27	34
1989	50094	Daroca	262	228	34	19	77	88	78
1989	50095	Ejea de los Caballeros	4647	3790	857	863	1648	1063	1073
1989	50096	Embid de Ariza	23	23	0	4	3	8	8
1989	50098	Encinacorba	217	171	46	27	64	67	59
1989	50099	Épila	1244	1056	188	297	473	277	197
1989	50100	Erla	60	39	21	9	18	12	21
1989	50101	Escatrón	470	314	156	66	149	131	124
1989	50102	Fabara	552	337	215	117	198	162	75
1989	50104	Farlete	142	129	13	12	63	33	34
1989	50105	Fayón	125	89	36	9	35	34	47
1989	50106	Fayos (Los)	86	66	20	4	28	24	30
1989	50107	Figueruelas	124	117	7	16	44	36	28
1989	50108	Fombuena	7	7	0	0	4	1	2
1989	50109	Frago (El)	45	35	10	3	6	22	14
1989	50110	Frasno (El)	601	428	173	112	217	162	110
1989	50111	Fréscano	101	81	20	33	34	26	8
1989	50113	Fuendejalón	338	287	51	58	165	61	54
1989	50114	Fuendetodos	56	52	4	11	15	20	10
1989	50115	Fuentes de Ebro	658	620	38	101	289	174	94
1989	50116	Fuentes de Jiloca	205	188	17	35	65	54	51
1989	50117	Gallocanta	51	45	6	15	20	15	1
1989	50118	Gallur	610	531	79	108	205	181	116
1989	50119	Gelsa	419	307	112	80	129	153	57
1989	50120	Godojos	62	54	8	7	13	17	25
1989	50121	Gotor	157	110	47	37	70	33	17
1989	50122	Grisel	51	41	10	7	19	16	9
1989	50123	Grisén	84	79	5	9	23	27	25
1989	50124	Herrera de los Navarros	267	217	50	38	68	74	87
1989	50125	Ibdes	296	265	31	47	92	78	79
1989	50126	Illueca	394	318	76	66	138	106	84
1989	50128	Isuerre	39	34	5	4	9	3	23
1989	50129	Jaraba	90	78	12	3	40	22	25
1989	50130	Jarque	334	229	105	68	101	100	65
1989	50131	Jaulín	80	69	11	17	26	24	13
1989	50132	Joyosa (La)	89	80	9	10	40	22	17
1989	50133	Lagata	49	45	4	4	14	25	6
1989	50134	Langa del Castillo	39	32	7	5	17	16	1
1989	50135	Layana	7	6	1	1	4	0	2
1989	50136	Lécera	224	214	10	33	78	69	44
1989	50137	Leciñena	290	273	17	70	128	75	17
1989	50138	Lechón	22	19	3	2	9	6	5
1989	50139	Letux	141	122	19	16	47	51	27
1989	50140	Litago	89	71	18	13	27	21	28
1989	50141	Lituénigo	92	65	27	15	21	44	12
1989	50142	Lobera de Onsella	77	56	21	2	12	17	46
1989	50143	Longares	579	394	185	148	219	126	86
1989	50144	Longás	59	44	15	4	12	10	33
1989	50146	Lucena de Jalón	143	109	34	34	37	42	30
1989	50147	Luceni	215	203	12	20	84	69	42
1989	50148	Luesia	137	108	29	25	36	52	24
1989	50149	Luesma	21	15	6	2	5	5	9
1989	50150	Lumpiaque	161	140	21	19	65	34	43
1989	50151	Luna	623	475	148	55	168	158	242
1989	50152	Maella	1025	704	321	167	409	256	193
1989	50153	Magallón	554	439	115	163	197	147	47
1989	50154	Mainar	33	32	1	9	16	5	3
1989	50155	Malanquilla	51	42	9	2	19	16	14
1989	50156	Maleján	0	0	0	0	0	0	0
1989	50157	Malón	140	109	31	21	47	33	39
1989	50159	Maluenda	392	327	65	54	169	101	68
1989	50160	Mallén	584	488	96	130	224	162	68
1989	50161	Manchones	66	51	15	3	22	19	22
1989	50162	Mara	216	140	76	27	68	61	60
1989	50163	María de Huerva	161	147	14	33	50	43	35
1989	50164	Mediana de Aragón	186	165	21	26	58	54	48
1989	50165	Mequinenza	801	531	270	144	315	176	166
1989	50166	Mesones de Isuela	197	156	41	35	76	44	42
1989	50167	Mezalocha	152	102	50	40	51	48	13
1989	50168	Mianos	17	15	2	4	7	3	3
1989	50169	Miedes de Aragón	269	210	59	50	101	78	40
1989	50170	Monegrillo	194	165	29	30	83	42	39
1989	50171	Moneva	56	51	5	6	25	15	10
1989	50172	Monreal de Ariza	124	89	35	31	54	38	1
1989	50173	Monterde	36	36	0	1	18	11	6
1989	50174	Montón	113	81	32	12	49	33	19
1989	50175	Morata de Jalón	634	506	128	59	226	199	150
1989	50176	Morata de Jiloca	174	118	56	19	69	57	29
1989	50177	Morés	377	293	84	71	107	112	87
1989	50178	Moros	355	305	50	54	110	105	86
1989	50179	Moyuela	133	106	27	19	44	52	18
1989	50180	Mozota	53	51	2	2	15	25	11
1989	50181	Muel	219	192	27	18	75	80	46
1989	50182	Muela (La)	195	163	32	29	56	53	57
1989	50183	Munébrega	317	248	69	51	114	95	57
1989	50184	Murero	64	54	10	9	20	21	14
1989	50185	Murillo de Gállego	88	67	21	5	14	33	36
1989	50186	Navardún	39	27	12	5	11	8	15
1989	50187	Nigüella	62	53	9	4	18	19	21
1989	50188	Nombrevilla	12	11	1	1	6	3	2
1989	50189	Nonaspe	437	304	133	83	146	107	101
1989	50190	Novallas	207	178	29	20	67	57	63
1989	50191	Novillas	404	330	74	88	165	104	47
1989	50192	Nuévalos	15	15	0	3	7	4	1
1989	50193	Nuez de Ebro	73	66	7	6	24	31	12
1989	50194	Olvés	209	140	69	50	80	57	22
1989	50195	Orcajo	23	16	7	1	12	10	0
1989	50196	Orera	130	92	38	26	39	41	24
1989	50197	Orés	50	39	11	1	15	13	21
1989	50198	Oseja	92	50	42	1	38	30	23
1989	50199	Osera de Ebro	74	64	10	7	35	22	10
1989	50200	Paniza	629	451	178	137	239	129	124
1989	50201	Paracuellos de Jiloca	277	241	36	39	105	76	57
1989	50202	Paracuellos de la Ribera	328	219	109	46	120	96	66
1989	50203	Pastriz	206	186	20	20	75	61	50
1989	50204	Pedrola	485	393	92	91	205	142	47
1989	50205	Pedrosas (Las)	39	36	3	6	9	8	16
1989	50206	Perdiguera	157	143	14	33	53	47	24
1989	50207	Piedratajada	101	86	15	10	35	20	36
1989	50208	Pina de Ebro	591	504	87	64	201	183	143
1989	50209	Pinseque	212	207	5	21	90	61	40
1989	50210	Pintanos (Los)	68	52	16	3	21	20	24
1989	50211	Plasencia de Jalón	138	126	12	18	61	34	25
1989	50212	Pleitas	29	24	5	4	9	10	6
1989	50213	Plenas	90	69	21	11	34	31	14
1989	50214	Pomer	47	33	14	1	3	17	26
1989	50215	Pozuel de Ariza	18	11	7	3	1	12	2
1989	50216	Pozuelo de Aragón	142	124	18	36	54	32	20
1989	50217	Pradilla de Ebro	222	171	51	49	78	62	33
1989	50218	Puebla de Albortón	61	54	7	8	27	17	9
1989	50219	Puebla de Alfindén (La)	130	126	4	13	46	40	31
1989	50220	Puendeluna	38	31	7	4	5	13	16
1989	50221	Purujosa	3	2	1	1	0	2	0
1989	50222	Quinto	386	368	18	64	165	94	63
1989	50223	Remolinos	153	128	25	34	60	46	13
1989	50224	Retascón	52	44	8	10	24	15	3
1989	50225	Ricla	1157	857	300	316	449	246	146
1989	50227	Romanos	55	51	4	11	20	13	11
1989	50228	Rueda de Jalón	261	230	31	41	108	65	47
1989	50229	Ruesca	69	44	25	20	20	20	9
1989	50230	Sádaba	327	272	55	43	111	88	85
1989	50231	Salillas de Jalón	70	59	11	9	16	18	27
1989	50232	Salvatierra de Esca	62	52	10	5	19	17	21
1989	50233	Samper del Salz	26	22	4	1	10	6	9
1989	50234	San Martín de la Virgen de Moncayo	40	30	10	4	19	10	7
1989	50235	San Mateo de Gállego	311	285	26	48	116	99	48
1989	50236	Santa Cruz de Grío	261	191	70	36	79	75	71
1989	50237	Santa Cruz de Moncayo	56	44	12	5	18	14	19
1989	50238	Santa Eulalia de Gállego	57	40	17	0	14	17	26
1989	50239	Santed	25	22	3	4	12	9	0
1989	50240	Sástago	281	257	24	35	115	72	59
1989	50241	Saviñán	426	332	94	84	139	125	78
1989	50242	Sediles	102	65	37	9	39	31	23
1989	50243	Sestrica	537	404	133	134	212	121	70
1989	50244	Sierra de Luna	112	96	16	14	40	34	24
1989	50245	Sigüés	72	58	14	7	17	18	30
1989	50246	Sisamón	23	22	1	3	9	8	3
1989	50247	Sobradiel	148	131	17	17	55	47	29
1989	50248	Sos del Rey Católico	279	227	52	47	89	60	83
1989	50249	Tabuenca	303	232	71	28	133	85	57
1989	50250	Talamantes	33	26	7	1	8	12	12
1989	50251	Tarazona	1584	1385	199	200	576	449	359
1989	50252	Tauste	1770	1553	217	399	599	463	309
1989	50253	Terrer	284	170	114	31	89	76	88
1989	50254	Tierga	206	180	26	44	86	44	32
1989	50255	Tobed	170	114	56	27	60	47	36
1989	50256	Torralba de los Frailes	43	41	2	7	17	15	4
1989	50257	Torralba de Ribota	117	86	31	9	41	38	29
1989	50258	Torralbilla	25	25	0	1	10	10	4
1989	50259	Torrehermosa	49	36	13	12	18	19	0
1989	50260	Torrelapaja	16	10	6	2	11	3	0
1989	50261	Torrellas	48	36	12	5	10	14	19
1989	50262	Torres de Berrellén	418	346	72	59	154	118	87
1989	50263	Torrijo de la Cañada	431	336	95	57	148	104	122
1989	50264	Tosos	271	201	70	32	93	92	54
1989	50265	Trasmoz	69	50	19	7	23	29	10
1989	50266	Trasobares	134	117	17	9	40	45	40
1989	50267	Uncastillo	447	351	96	43	99	123	182
1989	50268	Undués de Lerda	43	25	18	4	6	12	21
1989	50269	Urrea de Jalón	164	132	32	37	58	50	19
1989	50270	Urriés	35	28	7	0	6	8	21
1989	50271	Used	114	99	15	19	63	21	11
1989	50272	Utebo	280	261	19	21	136	78	45
1989	50273	Valdehorna	46	33	13	2	12	15	17
1989	50274	Val de San Martín	39	25	14	3	10	18	8
1989	50275	Valmadrid	37	31	6	2	9	18	8
1989	50276	Valpalmas	88	67	21	9	36	25	18
1989	50277	Valtorres	47	32	15	0	14	18	15
1989	50278	Velilla de Ebro	101	73	28	17	36	33	15
1989	50279	Velilla de Jiloca	96	67	29	22	32	29	13
1989	50280	Vera de Moncayo	160	133	27	19	51	46	44
1989	50281	Vierlas	39	27	12	4	15	9	11
1989	50282	Vilueña (La)	87	66	21	22	19	31	15
1989	50283	Villadoz	36	29	7	3	22	11	0
1989	50284	Villafeliche	148	111	37	14	42	57	35
1989	50285	Villafranca de Ebro	158	144	14	9	50	71	28
1989	50286	Villalba de Perejil	67	57	10	7	26	18	16
1989	50287	Villalengua	230	177	53	47	70	62	51
1989	50288	Villanueva de Gállego	485	424	61	64	177	138	106
1989	50289	Villanueva de Jiloca	67	50	17	2	23	26	16
1989	50290	Villanueva de Huerva	428	298	130	92	129	133	74
1989	50291	Villar de los Navarros	84	71	13	13	26	29	16
1989	50292	Villarreal de Huerva	29	25	4	2	14	12	1
1989	50293	Villarroya de la Sierra	610	408	202	136	186	175	113
1989	50294	Villarroya del Campo	29	28	1	4	11	9	5
1989	50295	Vistabella	154	129	25	7	36	48	63
1989	50296	Zaida (La)	67	62	5	5	31	25	6
1989	50297	Zaragoza	3154	2610	544	384	1172	982	616
1989	50298	Zuera	769	714	55	92	280	236	161
1989	50901	Biel	53	42	11	2	14	18	19
1999	22001	Abiego	85	73	12	15	30	18	22
1999	22002	Abizanda	49	36	13	7	16	16	10
1999	22003	Adahuesca	60	51	9	4	29	6	21
1999	22004	Agüero	78	60	18	6	19	18	35
1999	22006	Aísa	40	34	6	7	8	11	14
1999	22007	Albalate de Cinca	287	227	60	34	125	79	49
1999	22008	Albalatillo	29	23	6	5	11	6	7
1999	22009	Albelda	486	360	126	103	173	99	111
1999	22011	Albero Alto	29	26	3	5	8	4	12
1999	22012	Albero Bajo	62	54	8	13	23	13	13
1999	22013	Alberuela de Tubo	71	57	14	13	42	8	8
1999	22014	Alcalá de Gurrea	60	52	8	17	19	12	12
1999	22015	Alcalá del Obispo	121	99	22	9	54	25	33
1999	22016	Alcampell	431	291	140	66	132	96	137
1999	22017	Alcolea de Cinca	244	197	47	25	102	53	64
1999	22018	Alcubierre	130	104	26	22	41	29	38
1999	22019	Alerre	16	15	1	4	6	1	5
1999	22020	Alfántega	58	46	12	11	26	14	7
1999	22021	Almudévar	639	532	107	101	214	132	192
1999	22022	Almunia de San Juan	182	140	42	27	64	43	48
1999	22023	Almuniente	165	144	21	30	91	21	23
1999	22024	Alquézar	95	81	14	4	38	17	36
1999	22025	Altorricón	307	229	78	57	131	61	58
1999	22027	Angüés	105	96	9	12	38	20	35
1999	22028	Ansó	35	32	3	3	15	9	8
1999	22029	Antillón	59	40	19	7	31	12	9
1999	22032	Aragüés del Puerto	20	17	3	4	8	2	6
1999	22035	Arén	72	58	14	10	27	13	22
1999	22036	Argavieso	30	29	1	2	8	10	10
1999	22037	Arguis	24	18	6	3	6	7	8
1999	22039	Ayerbe	187	149	38	14	54	47	72
1999	22040	Azanuy-Alins	140	92	48	10	45	34	51
1999	22041	Azara	81	64	17	15	32	15	19
1999	22042	Azlor	80	57	23	17	27	14	22
1999	22043	Baells	87	76	11	11	32	18	26
1999	22044	Bailo	115	101	14	14	47	16	38
1999	22045	Baldellou	93	75	18	7	24	19	43
1999	22046	Ballobar	364	223	141	78	177	50	59
1999	22047	Banastás	4	4	0	2	0	1	1
1999	22048	Barbastro	727	550	177	67	240	173	247
1999	22049	Barbués	51	40	11	9	22	12	8
1999	22050	Barbuñales	46	36	10	3	19	16	8
1999	22051	Bárcabo	62	41	21	7	17	18	20
1999	22052	Belver de Cinca	531	399	132	153	208	94	76
1999	22053	Benabarre	333	236	97	26	137	67	103
1999	22054	Benasque	45	32	13	9	9	11	16
1999	22055	Berbegal	138	110	28	17	56	31	34
1999	22057	Bielsa	46	35	11	6	19	9	12
1999	22058	Bierge	126	105	21	9	38	21	58
1999	22059	Biescas	151	119	32	18	46	28	59
1999	22060	Binaced	469	326	143	91	221	83	74
1999	22061	Binéfar	268	219	49	16	101	58	93
1999	22062	Bisaurri	67	51	16	7	29	16	15
1999	22063	Biscarrués	84	70	14	16	26	14	28
1999	22064	Blecua y Torres	65	56	9	8	27	14	16
1999	22066	Boltaña	54	44	10	9	25	5	15
1999	22067	Bonansa	23	15	8	6	11	3	3
1999	22068	Borau	9	8	1	1	5	2	1
1999	22069	Broto	83	61	22	16	48	10	9
1999	22072	Caldearenas	60	56	4	9	25	14	12
1999	22074	Campo	13	11	2	0	7	2	4
1999	22075	Camporrells	74	55	19	3	23	12	36
1999	22076	Canal de Berdún	135	113	22	17	42	29	47
1999	22077	Candasnos	117	87	30	38	47	22	10
1999	22078	Canfranc	6	4	2	2	3	0	1
1999	22079	Capdesaso	24	21	3	2	12	7	3
1999	22080	Capella	112	86	26	11	53	19	29
1999	22081	Casbas de Huesca	130	112	18	17	60	30	23
1999	22082	Castejón del Puente	64	49	15	13	21	22	8
1999	22083	Castejón de Monegros	203	170	33	33	67	53	50
1999	22084	Castejón de Sos	32	26	6	4	5	11	12
1999	22085	Castelflorite	74	57	17	20	21	24	9
1999	22086	Castiello de Jaca	14	13	1	2	5	4	3
1999	22087	Castigaleu	25	21	4	5	13	4	3
1999	22088	Castillazuelo	124	81	43	15	35	15	59
1999	22089	Castillonroy	155	102	53	25	66	24	40
1999	22090	Colungo	94	57	37	5	27	17	45
1999	22094	Chalamera	55	40	15	8	18	12	17
1999	22095	Chía	21	18	3	6	8	4	3
1999	22096	Chimillas	17	16	1	5	6	2	4
1999	22099	Esplús	205	159	46	25	68	35	77
1999	22102	Estada	60	42	18	6	26	13	15
1999	22103	Estadilla	254	173	81	32	92	59	71
1999	22105	Estopiñán del Castillo	121	82	39	11	32	19	59
1999	22106	Fago	9	8	1	3	2	3	1
1999	22107	Fanlo	9	8	1	0	3	2	4
1999	22109	Fiscal	55	46	9	12	20	15	8
1999	22110	Fonz	271	219	52	36	89	60	86
1999	22111	Foradada del Toscar	77	54	23	19	37	14	7
1999	22112	Fraga	1948	1278	670	440	780	411	317
1999	22113	Fueva (La)	202	146	56	26	96	38	42
1999	22114	Gistaín	85	60	25	15	32	17	21
1999	22115	Grado (El)	190	147	43	19	68	34	69
1999	22116	Grañén	308	256	52	50	148	51	59
1999	22117	Graus	450	337	113	71	146	102	131
1999	22119	Gurrea de Gállego	315	285	30	49	129	72	65
1999	22122	Hoz de Jaca	10	9	1	2	1	3	4
1999	22124	Huerto	128	103	25	27	63	22	16
1999	22125	Huesca	440	378	62	49	142	112	137
1999	22126	Ibieca	25	23	2	4	11	4	6
1999	22127	Igriés	57	47	10	6	24	10	17
1999	22128	Ilche	109	96	13	17	52	18	22
1999	22129	Isábena	99	69	30	5	51	18	25
1999	22130	Jaca	410	337	73	65	140	84	121
1999	22131	Jasa	19	16	3	4	6	5	4
1999	22133	Labuerda	10	9	1	0	5	2	3
1999	22135	Laluenga	104	89	15	27	35	16	26
1999	22136	Lalueza	244	203	41	35	126	45	38
1999	22137	Lanaja	433	348	85	80	159	87	107
1999	22139	Laperdiguera	27	23	4	7	7	4	9
1999	22141	Lascellas-Ponzano	85	66	19	11	32	19	23
1999	22142	Lascuarre	37	30	7	7	12	6	12
1999	22143	Laspaúles	70	47	23	8	34	15	13
1999	22144	Laspuña	37	33	4	4	13	7	13
1999	22149	Loarre	166	135	31	19	61	31	55
1999	22150	Loporzano	245	192	53	33	80	55	77
1999	22151	Loscorrales	53	43	10	3	16	6	28
1999	22155	Monesma y Cajigar	47	36	11	6	20	10	11
1999	22156	Monflorite-Lascasas	62	50	12	9	28	15	10
1999	22157	Montanuy	136	103	33	24	56	30	26
1999	22158	Monzón	881	695	186	134	319	236	192
1999	22160	Naval	43	40	3	8	18	5	12
1999	22162	Novales	37	31	6	5	17	3	12
1999	22163	Nueno	93	78	15	6	36	20	31
1999	22164	Olvena	38	25	13	6	20	3	9
1999	22165	Ontiñena	201	155	46	32	78	46	45
1999	22167	Osso de Cinca	249	171	78	68	104	47	30
1999	22168	Palo	12	10	2	2	5	4	1
1999	22170	Panticosa	29	26	3	4	16	3	6
1999	22172	Peñalba	167	131	36	48	75	26	18
1999	22173	Peñas de Riglos (Las)	91	79	12	13	38	10	30
1999	22174	Peralta de Alcofea	204	152	52	47	78	33	46
1999	22175	Peralta de Calasanz	179	141	38	15	52	37	75
1999	22176	Peraltilla	72	52	20	7	37	12	16
1999	22177	Perarrúa	36	30	6	5	8	12	11
1999	22178	Pertusa	39	35	4	7	18	7	7
1999	22181	Piracés	52	43	9	16	8	12	16
1999	22182	Plan	115	82	33	13	45	17	40
1999	22184	Poleñino	84	75	9	12	31	20	21
1999	22186	Pozán de Vero	151	94	57	12	48	27	64
1999	22187	Puebla de Castro (La)	86	65	21	12	26	14	34
1999	22188	Puente de Montañana	20	15	5	5	4	5	6
1999	22189	Puértolas	38	30	8	5	21	6	6
1999	22190	Pueyo de Araguás (El)	44	35	9	7	24	9	4
1999	22193	Pueyo de Santa Cruz	60	45	15	15	18	12	15
1999	22195	Quicena	15	11	4	4	5	1	5
1999	22197	Robres	203	174	29	35	77	40	51
1999	22199	Sabiñánigo	264	220	44	50	80	43	91
1999	22200	Sahún	51	40	11	8	26	9	8
1999	22201	Salas Altas	207	154	53	22	74	46	65
1999	22202	Salas Bajas	107	77	30	14	39	12	42
1999	22203	Salillas	31	27	4	5	10	5	11
1999	22204	Sallent de Gállego	102	85	17	12	33	19	38
1999	22205	San Esteban de Litera	336	270	66	31	113	98	94
1999	22206	Sangarrén	68	61	7	12	21	18	17
1999	22207	San Juan de Plan	73	53	20	19	15	19	20
1999	22208	Santa Cilia	34	28	6	9	14	6	5
1999	22209	Santa Cruz de la Serós	36	28	8	7	15	7	7
1999	22212	Santaliestra y San Quílez	18	16	2	2	8	3	5
1999	22213	Sariñena	583	474	109	116	275	115	77
1999	22214	Secastilla	57	40	17	4	22	11	20
1999	22215	Seira	30	20	10	1	12	7	10
1999	22217	Sena	181	149	32	40	81	36	24
1999	22218	Senés de Alcubierre	24	20	4	7	12	4	1
1999	22220	Sesa	62	59	3	9	17	15	21
1999	22221	Sesué	18	12	6	0	4	3	11
1999	22222	Siétamo	130	112	18	16	45	23	46
1999	22223	Sopeira	21	16	5	5	7	6	3
1999	22225	Tamarite de Litera	830	547	283	144	314	170	202
1999	22226	Tardienta	175	146	29	23	60	35	57
1999	22227	Tella-Sin	14	14	0	0	7	1	6
1999	22228	Tierz	29	26	3	9	7	4	9
1999	22229	Tolva	78	56	22	8	32	14	24
1999	22230	Torla-Ordesa	52	39	13	4	26	9	13
1999	22232	Torralba de Aragón	47	39	8	11	17	12	7
1999	22233	Torre la Ribera	53	37	16	4	18	12	19
1999	22234	Torrente de Cinca	259	163	96	65	111	48	35
1999	22235	Torres de Alcanadre	41	35	6	5	21	4	11
1999	22236	Torres de Barbués	60	53	7	10	23	11	16
1999	22239	Tramaced	52	42	10	10	26	10	6
1999	22242	Valfarta	66	53	13	24	17	10	15
1999	22243	Valle de Bardají	16	13	3	5	6	4	1
1999	22244	Valle de Lierp	18	14	4	2	5	5	6
1999	22245	Velilla de Cinca	145	100	45	37	52	20	36
1999	22246	Beranuy	72	53	19	1	20	13	38
1999	22247	Viacamp y Litera	33	23	10	3	13	12	5
1999	22248	Vicién	11	10	1	0	8	0	3
1999	22249	Villanova	10	9	1	1	4	3	2
1999	22250	Villanúa	10	7	3	0	2	3	5
1999	22251	Villanueva de Sigena	183	138	45	42	81	31	29
1999	22252	Yebra de Basa	30	29	1	6	13	4	7
1999	22253	Yésero	11	6	5	4	3	3	1
1999	22254	Zaidín	565	436	129	157	231	86	91
1999	22901	Valle de Hecho	182	147	35	37	67	38	40
1999	22902	Puente la Reina de Jaca	80	66	14	16	22	13	29
1999	22903	San Miguel del Cinca	284	223	61	75	116	44	49
1999	22904	Sotonera (La)	485	389	96	43	170	91	181
1999	22905	Lupiñén-Ortilla	97	89	8	21	38	18	20
1999	22906	Santa María de Dulcis	124	80	44	11	47	24	42
1999	22907	Aínsa-Sobrarbe	195	167	28	24	85	38	48
1999	22908	Hoz y Costeán	187	137	50	27	71	23	66
1999	22909	Vencillón	137	117	20	46	52	21	18
1999	44001	Ababuj	36	24	12	3	17	10	6
1999	44002	Abejuela	19	12	7	2	8	2	7
1999	44003	Aguatón	11	9	2	1	1	5	4
1999	44004	Aguaviva	130	91	39	10	46	29	45
1999	44005	Aguilar del Alfambra	35	24	11	1	10	10	14
1999	44006	Alacón	173	116	57	7	61	44	61
1999	44007	Alba	94	78	16	15	37	24	18
1999	44008	Albalate del Arzobispo	762	556	206	62	272	167	261
1999	44009	Albarracín	88	68	20	12	38	13	25
1999	44010	Albentosa	72	53	19	6	33	17	16
1999	44011	Alcaine	10	8	2	4	4	2	0
1999	44012	Alcalá de la Selva	55	42	13	7	19	19	10
1999	44013	Alcañiz	1385	977	408	197	527	298	363
1999	44014	Alcorisa	1014	686	328	154	399	176	285
1999	44016	Alfambra	221	161	60	29	84	49	59
1999	44017	Aliaga	88	64	24	16	26	14	32
1999	44018	Almohaja	5	4	1	1	1	1	2
1999	44019	Alobras	24	21	3	4	10	3	7
1999	44020	Alpeñés	11	9	2	0	4	5	2
1999	44021	Allepuz	62	47	15	5	27	15	15
1999	44022	Alloza	547	358	189	48	200	125	174
1999	44023	Allueva	1	1	0	1	0	0	0
1999	44024	Anadón	11	6	5	4	3	4	0
1999	44025	Andorra	991	603	388	123	410	201	257
1999	44026	Arcos de las Salinas	29	22	7	3	7	11	8
1999	44027	Arens de Lledó	145	92	53	27	63	35	20
1999	44028	Argente	86	74	12	6	37	20	23
1999	44029	Ariño	100	85	15	9	30	21	40
1999	44031	Azaila	90	64	26	11	26	24	29
1999	44032	Bádenas	5	5	0	0	0	3	2
1999	44033	Báguena	226	186	40	19	62	44	101
1999	44034	Bañón	46	40	6	16	9	15	6
1999	44035	Barrachina	39	24	15	4	18	9	8
1999	44036	Bea	8	6	2	5	3	0	0
1999	44037	Beceite	126	104	22	10	52	28	36
1999	44038	Belmonte de San José	152	94	58	20	40	34	58
1999	44039	Bello	145	100	45	16	40	34	55
1999	44040	Berge	138	99	39	14	52	26	46
1999	44041	Bezas	10	9	1	0	1	5	4
1999	44042	Blancas	70	44	26	5	34	21	10
1999	44043	Blesa	70	60	10	10	21	16	23
1999	44044	Bordón	35	22	13	5	14	8	8
1999	44045	Bronchales	32	23	9	5	16	7	4
1999	44046	Bueña	42	31	11	3	10	11	18
1999	44047	Burbáguena	187	113	74	4	35	45	103
1999	44048	Cabra de Mora	22	13	9	2	6	9	5
1999	44049	Calaceite	510	360	150	106	203	93	108
1999	44050	Calamocha	566	432	134	60	216	147	143
1999	44051	Calanda	807	551	256	140	332	135	200
1999	44052	Calomarde	16	11	5	0	7	6	3
1999	44053	Camañas	58	47	11	15	20	13	10
1999	44054	Camarena de la Sierra	20	14	6	6	7	7	0
1999	44055	Camarillas	43	32	11	9	16	11	7
1999	44056	Caminreal	243	170	73	24	94	67	58
1999	44059	Cantavieja	194	122	72	22	102	48	22
1999	44060	Cañada de Benatanduz	24	17	7	2	11	5	6
1999	44061	Cañada de Verich (La)	19	15	4	1	4	5	9
1999	44062	Cañada Vellida	48	45	3	10	12	14	12
1999	44063	Cañizar del Olivar	20	15	5	1	3	6	10
1999	44064	Cascante del Río	28	23	5	5	7	9	7
1999	44065	Castejón de Tornos	56	33	23	7	18	15	16
1999	44066	Castel de Cabra	28	18	10	1	4	10	13
1999	44067	Castelnou	30	24	6	4	9	6	11
1999	44068	Castelserás	156	110	46	15	60	24	57
1999	44070	Castellar (El)	28	21	7	1	6	14	7
1999	44071	Castellote	360	230	130	45	129	81	105
1999	44074	Cedrillas	118	82	36	6	52	36	24
1999	44075	Celadas	163	119	44	34	69	42	18
1999	44076	Cella	526	375	151	39	255	145	87
1999	44077	Cerollera (La)	61	41	20	3	18	12	28
1999	44080	Codoñera (La)	155	95	60	26	49	29	51
1999	44082	Corbalán	32	22	10	3	7	6	16
1999	44084	Cortes de Aragón	24	19	5	4	7	3	10
1999	44085	Cosa	39	33	6	13	8	16	2
1999	44086	Cretas	276	217	59	52	116	57	51
1999	44087	Crivillén	58	41	17	15	12	15	16
1999	44088	Cuba (La)	24	14	10	1	15	6	2
1999	44089	Cubla	28	21	7	7	4	7	10
1999	44090	Cucalón	27	25	2	3	9	11	4
1999	44092	Cuervo (El)	27	17	10	2	10	9	6
1999	44093	Cuevas de Almudén	45	34	11	10	19	7	9
1999	44094	Cuevas Labradas	42	31	11	3	12	17	10
1999	44096	Ejulve	53	34	19	7	15	13	18
1999	44097	Escorihuela	93	75	18	10	35	16	32
1999	44099	Escucha	59	51	8	12	24	10	13
1999	44100	Estercuel	61	54	7	5	15	16	25
1999	44101	Ferreruela de Huerva	47	34	13	4	10	11	22
1999	44102	Fonfría	15	9	6	6	1	5	3
1999	44103	Formiche Alto	41	32	9	3	16	8	14
1999	44105	Fórnoles	116	76	40	9	49	22	36
1999	44106	Fortanete	90	56	34	13	21	31	25
1999	44107	Foz-Calanda	120	80	40	26	39	29	26
1999	44108	Fresneda (La)	281	185	96	31	117	62	71
1999	44109	Frías de Albarracín	24	17	7	1	15	4	4
1999	44110	Fuenferrada	21	17	4	1	9	5	6
1999	44111	Fuentes Calientes	49	40	9	12	12	15	10
1999	44112	Fuentes Claras	234	175	59	31	83	61	59
1999	44113	Fuentes de Rubielos	9	7	2	0	6	1	2
1999	44114	Fuentespalda	111	80	31	13	41	34	23
1999	44115	Galve	78	50	28	22	16	26	14
1999	44116	Gargallo	22	19	3	2	7	5	8
1999	44117	Gea de Albarracín	71	51	20	7	23	21	20
1999	44118	Ginebrosa (La)	132	93	39	24	39	34	35
1999	44119	Griegos	28	21	7	1	13	8	6
1999	44120	Guadalaviar	66	40	26	17	38	7	4
1999	44121	Gúdar	25	18	7	5	8	7	5
1999	44122	Híjar	348	266	82	56	92	96	104
1999	44123	Hinojosa de Jarque	66	45	21	4	26	14	22
1999	44124	Hoz de la Vieja (La)	39	27	12	1	19	11	8
1999	44125	Huesa del Común	31	27	4	7	11	6	7
1999	44126	Iglesuela del Cid (La)	48	35	13	9	19	18	2
1999	44127	Jabaloyas	31	19	12	4	8	9	10
1999	44128	Jarque de la Val	45	37	8	7	8	12	18
1999	44129	Jatiel	13	10	3	2	5	1	5
1999	44130	Jorcas	25	19	6	6	7	7	5
1999	44131	Josa	7	6	1	0	5	1	1
1999	44132	Lagueruela	30	22	8	4	7	10	9
1999	44133	Lanzuela	18	16	2	1	4	4	9
1999	44135	Libros	101	68	33	2	29	23	47
1999	44136	Lidón	42	27	15	2	12	20	8
1999	44137	Linares de Mora	74	56	18	8	25	21	20
1999	44138	Loscos	75	62	13	8	24	24	19
1999	44141	Lledó	83	57	26	8	45	12	18
1999	44142	Maicas	5	4	1	0	1	3	1
1999	44143	Manzanera	97	70	27	13	29	35	20
1999	44144	Martín del Río	50	44	6	3	18	14	15
1999	44145	Mas de las Matas	182	146	36	11	65	41	65
1999	44146	Mata de los Olmos (La)	39	32	7	3	13	10	13
1999	44147	Mazaleón	267	188	79	33	120	71	43
1999	44148	Mezquita de Jarque	43	31	12	11	12	12	8
1999	44149	Mirambel	52	37	15	9	23	18	2
1999	44150	Miravete de la Sierra	22	15	7	0	6	8	8
1999	44151	Molinos	189	134	55	15	56	31	87
1999	44152	Monforte de Moyuela	60	40	20	9	30	14	7
1999	44153	Monreal del Campo	349	222	127	25	108	90	126
1999	44154	Monroyo	171	125	46	20	77	34	40
1999	44155	Montalbán	29	20	9	3	14	8	4
1999	44156	Monteagudo del Castillo	31	22	9	2	18	3	8
1999	44157	Monterde de Albarracín	24	14	10	4	9	9	2
1999	44158	Mora de Rubielos	166	120	46	13	50	45	58
1999	44159	Moscardón	15	11	4	1	5	4	5
1999	44160	Mosqueruela	176	112	64	17	53	60	46
1999	44161	Muniesa	309	199	110	40	111	70	88
1999	44163	Noguera de Albarracín	22	19	3	3	12	3	4
1999	44164	Nogueras	14	13	1	0	5	3	6
1999	44165	Nogueruelas	39	31	8	2	14	15	8
1999	44167	Obón	29	23	6	2	3	13	11
1999	44168	Odón	119	76	43	21	50	32	16
1999	44169	Ojos Negros	111	79	32	18	47	31	15
1999	44171	Olba	17	12	5	1	13	1	2
1999	44172	Oliete	178	136	42	10	40	34	94
1999	44173	Olmos (Los)	122	93	29	20	42	21	39
1999	44174	Orihuela del Tremedal	25	23	2	5	8	7	5
1999	44175	Orrios	76	58	18	10	25	16	25
1999	44176	Palomar de Arroyos	28	19	9	3	14	5	6
1999	44177	Pancrudo	68	54	14	9	25	12	22
1999	44178	Parras de Castellote (Las)	53	36	17	2	16	13	22
1999	44179	Peñarroya de Tastavins	214	142	72	33	99	40	42
1999	44180	Peracense	27	19	8	1	7	14	5
1999	44181	Peralejos	24	17	7	1	9	6	8
1999	44182	Perales del Alfambra	79	61	18	13	23	24	19
1999	44183	Pitarque	26	20	6	4	11	4	7
1999	44184	Plou	16	11	5	2	5	5	4
1999	44185	Pobo (El)	70	50	20	8	26	20	16
1999	44187	Portellada (La)	176	117	59	13	100	29	34
1999	44189	Pozondón	26	21	5	3	11	4	8
1999	44190	Pozuel del Campo	34	20	14	0	12	13	9
1999	44191	Puebla de Híjar (La)	188	158	30	14	57	33	84
1999	44192	Puebla de Valverde (La)	158	117	41	21	58	32	47
1999	44193	Puertomingalvo	66	40	26	4	24	19	19
1999	44194	Ráfales	104	70	34	12	40	27	25
1999	44195	Rillo	34	27	7	5	6	5	18
1999	44196	Riodeva	70	40	30	7	16	21	26
1999	44197	Ródenas	22	15	7	3	5	7	7
1999	44198	Royuela	43	28	15	6	13	21	3
1999	44199	Rubiales	7	4	3	2	3	2	0
1999	44200	Rubielos de la Cérida	16	14	2	6	3	5	2
1999	44201	Rubielos de Mora	56	48	8	2	27	10	17
1999	44203	Salcedillo	1	1	0	0	0	0	1
1999	44204	Saldón	13	8	5	1	4	7	1
1999	44205	Samper de Calanda	232	166	66	17	62	68	85
1999	44206	San Agustín	72	54	18	8	30	15	19
1999	44207	San Martín del Río	236	149	87	22	79	49	86
1999	44208	Santa Cruz de Nogueras	9	8	1	0	7	1	1
1999	44209	Santa Eulalia	184	143	41	17	55	61	51
1999	44210	Sarrión	265	198	67	40	95	56	74
1999	44211	Segura de los Baños	23	21	2	4	7	5	7
1999	44212	Seno	29	22	7	2	11	5	11
1999	44213	Singra	50	39	11	4	17	10	19
1999	44215	Terriente	56	38	18	5	21	13	17
1999	44216	Teruel	532	395	137	61	196	143	132
1999	44217	Toril y Masegoso	15	12	3	1	6	4	4
1999	44218	Tormón	3	3	0	0	0	1	2
1999	44219	Tornos	141	86	55	12	42	36	51
1999	44220	Torralba de los Sisones	81	63	18	12	27	18	24
1999	44221	Torrecilla de Alcañiz	133	91	42	20	48	25	40
1999	44222	Torrecilla del Rebollar	57	43	14	10	21	14	12
1999	44223	Torre de Arcas	41	27	14	2	17	14	8
1999	44224	Torre de las Arcas	11	9	2	0	4	1	6
1999	44225	Torre del Compte	102	59	43	6	57	14	25
1999	44226	Torrelacárcel	92	62	30	9	20	22	41
1999	44227	Torre los Negros	35	25	10	10	10	11	4
1999	44228	Torremocha de Jiloca	48	32	16	1	17	13	17
1999	44229	Torres de Albarracín	30	21	9	1	14	11	4
1999	44230	Torrevelilla	98	67	31	9	36	14	39
1999	44231	Torrijas	12	11	1	1	5	4	2
1999	44232	Torrijo del Campo	160	112	48	12	67	33	48
1999	44234	Tramacastiel	47	41	6	2	18	10	17
1999	44235	Tramacastilla	24	14	10	0	11	8	5
1999	44236	Tronchón	35	25	10	6	17	9	3
1999	44237	Urrea de Gaén	224	165	59	31	86	49	58
1999	44238	Utrillas	18	14	4	2	8	6	2
1999	44239	Valacloche	11	9	2	0	1	5	5
1999	44240	Valbona	44	30	14	8	19	10	7
1999	44241	Valdealgorfa	316	193	123	49	129	61	77
1999	44243	Valdecuenca	2	1	1	0	2	0	0
1999	44244	Valdelinares	26	20	6	3	10	7	6
1999	44245	Valdeltormo	84	62	22	15	29	23	17
1999	44246	Valderrobres	603	417	186	72	267	111	153
1999	44247	Valjunquera	185	127	58	25	85	42	33
1999	44249	Vallecillo (El)	5	4	1	0	1	2	2
1999	44250	Veguillas de la Sierra	9	9	0	2	3	0	4
1999	44251	Villafranca del Campo	106	70	36	17	43	30	16
1999	44252	Villahermosa del Campo	39	32	7	5	14	9	11
1999	44256	Villanueva del Rebollar de la Sierra	18	13	5	3	0	8	7
1999	44257	Villar del Cobo	44	30	14	10	23	11	0
1999	44258	Villar del Salz	26	19	7	8	6	8	4
1999	44260	Villarluengo	49	33	16	7	24	16	2
1999	44261	Villarquemado	224	171	53	30	97	50	47
1999	44262	Villarroya de los Pinares	38	29	9	5	16	8	9
1999	44263	Villastar	74	63	11	6	30	16	22
1999	44264	Villel	67	50	17	17	15	17	18
1999	44265	Vinaceite	82	66	16	2	27	23	30
1999	44266	Visiedo	92	62	30	9	43	23	17
1999	44267	Vivel del Río Martín	30	25	5	8	10	8	4
1999	44268	Zoma (La)	10	6	4	0	1	2	7
1999	50001	Abanto	43	29	14	4	25	8	6
1999	50002	Acered	183	119	64	33	85	36	29
1999	50003	Agón	98	72	26	23	34	21	20
1999	50004	Aguarón	445	314	131	66	169	93	117
1999	50005	Aguilón	109	78	31	10	35	27	37
1999	50006	Ainzón	633	480	153	139	253	111	130
1999	50007	Aladrén	54	46	8	5	19	15	15
1999	50008	Alagón	400	330	70	19	160	91	130
1999	50009	Alarba	107	74	33	28	44	16	19
1999	50010	Alberite de San Juan	58	39	19	10	26	12	10
1999	50011	Albeta	16	14	2	7	5	2	2
1999	50012	Alborge	19	12	7	6	9	2	2
1999	50013	Alcalá de Ebro	110	95	15	17	43	21	29
1999	50014	Alcalá de Moncayo	104	75	29	22	32	34	16
1999	50015	Alconchel de Ariza	44	35	9	11	12	15	6
1999	50016	Aldehuela de Liestos	27	23	4	1	5	8	13
1999	50017	Alfajarín	230	197	33	28	97	62	43
1999	50018	Alfamén	746	529	217	189	308	135	114
1999	50019	Alforque	19	13	6	2	6	9	2
1999	50020	Alhama de Aragón	80	76	4	11	21	17	31
1999	50021	Almochuel	21	15	6	4	8	7	2
1999	50022	Almolda (La)	240	188	52	31	77	56	76
1999	50023	Almonacid de la Cuba	140	115	25	14	55	28	43
1999	50024	Almonacid de la Sierra	593	428	165	128	214	113	138
1999	50025	Almunia de Doña Godina (La)	1671	1191	480	443	636	266	326
1999	50026	Alpartir	473	341	132	86	203	88	96
1999	50027	Ambel	288	207	81	40	103	60	85
1999	50028	Anento	68	51	17	3	27	20	18
1999	50029	Aniñón	770	481	289	198	266	172	134
1999	50030	Añón de Moncayo	84	63	21	13	28	27	16
1999	50031	Aranda de Moncayo	131	100	31	16	37	37	41
1999	50032	Arándiga	209	169	40	19	52	54	84
1999	50033	Ardisa	23	19	4	1	12	6	4
1999	50034	Ariza	146	121	25	21	41	32	52
1999	50035	Artieda	17	14	3	2	5	4	6
1999	50036	Asín	33	27	6	0	14	3	16
1999	50037	Atea	199	143	56	24	76	45	54
1999	50038	Ateca	487	354	133	118	150	115	104
1999	50039	Azuara	222	175	47	31	67	74	50
1999	50040	Badules	47	36	11	4	7	15	21
1999	50041	Bagüés	6	5	1	2	1	2	1
1999	50042	Balconchán	38	25	13	3	3	6	26
1999	50043	Bárboles	84	66	18	10	32	19	23
1999	50044	Bardallur	110	84	26	7	50	27	26
1999	50045	Belchite	751	536	215	121	258	180	192
1999	50046	Belmonte de Gracián	149	117	32	24	42	34	49
1999	50047	Berdejo	9	7	2	0	2	4	3
1999	50048	Berrueco	26	22	4	3	11	5	7
1999	50050	Bijuesca	38	29	9	3	14	6	15
1999	50051	Biota	278	251	27	62	110	69	37
1999	50052	Bisimbre	63	41	22	16	22	11	14
1999	50053	Boquiñeni	227	167	60	42	89	57	39
1999	50054	Bordalba	22	19	3	4	6	9	3
1999	50055	Borja	1085	781	304	235	462	181	207
1999	50056	Botorrita	53	40	13	4	15	18	16
1999	50057	Brea de Aragón	162	130	32	21	62	34	45
1999	50058	Bubierca	37	33	4	8	15	5	9
1999	50059	Bujaraloz	246	199	47	68	83	58	37
1999	50060	Bulbuente	198	134	64	21	61	37	79
1999	50061	Bureta	170	115	55	30	79	40	21
1999	50062	Burgo de Ebro (El)	123	102	21	17	40	27	39
1999	50063	Buste (El)	53	36	17	9	16	14	14
1999	50064	Cabañas de Ebro	122	108	14	14	49	33	26
1999	50065	Cabolafuente	26	24	2	4	10	7	5
1999	50066	Cadrete	49	40	9	9	7	21	12
1999	50067	Calatayud	613	526	87	90	192	156	175
1999	50068	Calatorao	798	589	209	172	288	160	178
1999	50069	Calcena	23	17	6	2	7	3	11
1999	50070	Calmarza	28	24	4	0	16	4	8
1999	50071	Campillo de Aragón	62	52	10	12	28	11	11
1999	50072	Carenas	58	40	18	5	19	11	23
1999	50073	Cariñena	869	645	224	131	366	173	199
1999	50074	Caspe	1400	1051	349	224	520	346	310
1999	50075	Castejón de Alarba	75	50	25	8	29	13	25
1999	50076	Castejón de las Armas	48	36	12	5	14	9	20
1999	50077	Castejón de Valdejasa	133	110	23	13	39	24	57
1999	50078	Castiliscar	131	92	39	9	37	37	48
1999	50079	Cervera de la Cañada	234	181	53	49	68	63	54
1999	50080	Cerveruela	6	6	0	0	0	2	4
1999	50081	Cetina	82	74	8	8	41	13	20
1999	50082	Cimballa	47	39	8	4	18	8	17
1999	50083	Cinco Olivas	14	11	3	1	6	2	5
1999	50084	Clarés de Ribota	113	79	34	13	47	25	28
1999	50085	Codo	36	26	10	4	10	8	14
1999	50086	Codos	174	136	38	24	40	42	68
1999	50087	Contamina	21	17	4	2	6	5	8
1999	50088	Cosuenda	412	280	132	88	159	80	85
1999	50089	Cuarte de Huerva	16	14	2	3	2	6	5
1999	50090	Cubel	89	70	19	13	37	23	16
1999	50091	Cuerlas (Las)	42	33	9	9	17	1	15
1999	50092	Chiprana	53	41	12	6	15	20	12
1999	50093	Chodes	113	85	28	13	23	33	44
1999	50094	Daroca	305	251	54	14	103	54	134
1999	50095	Ejea de los Caballeros	1925	1585	340	460	837	348	280
1999	50096	Embid de Ariza	29	25	4	4	12	2	11
1999	50098	Encinacorba	280	195	85	35	103	46	96
1999	50099	Épila	1043	813	230	240	417	200	186
1999	50100	Erla	46	32	14	4	20	6	16
1999	50101	Escatrón	311	212	99	34	128	54	95
1999	50102	Fabara	509	333	176	102	172	98	137
1999	50104	Farlete	182	159	23	24	78	37	43
1999	50105	Fayón	195	125	70	19	53	40	83
1999	50106	Fayos (Los)	89	66	23	8	27	16	38
1999	50107	Figueruelas	164	129	35	38	46	36	44
1999	50108	Fombuena	5	5	0	0	3	0	2
1999	50109	Frago (El)	20	17	3	1	1	2	16
1999	50110	Frasno (El)	508	353	155	89	184	91	144
1999	50111	Fréscano	66	49	17	14	29	14	9
1999	50113	Fuendejalón	442	334	108	62	223	105	52
1999	50114	Fuendetodos	62	49	13	9	22	8	23
1999	50115	Fuentes de Ebro	645	568	77	91	250	158	146
1999	50116	Fuentes de Jiloca	104	88	16	16	38	24	26
1999	50117	Gallocanta	42	34	8	6	18	9	9
1999	50118	Gallur	344	286	58	41	127	74	102
1999	50119	Gelsa	273	206	67	49	100	66	58
1999	50120	Godojos	60	44	16	4	17	14	25
1999	50121	Gotor	178	131	47	23	79	47	29
1999	50122	Grisel	60	51	9	4	13	13	30
1999	50123	Grisén	84	64	20	15	28	14	27
1999	50124	Herrera de los Navarros	194	160	34	35	64	38	57
1999	50125	Ibdes	203	164	39	24	64	47	68
1999	50126	Illueca	343	274	69	37	121	77	108
1999	50128	Isuerre	24	21	3	0	4	6	14
1999	50129	Jaraba	53	46	7	6	22	11	14
1999	50130	Jarque	364	241	123	63	115	82	104
1999	50131	Jaulín	51	37	14	8	21	15	7
1999	50132	Joyosa (La)	52	38	14	5	24	16	7
1999	50133	Lagata	44	41	3	3	16	4	21
1999	50134	Langa del Castillo	106	80	26	10	46	21	29
1999	50135	Layana	4	3	1	2	0	1	1
1999	50136	Lécera	245	203	42	32	83	51	79
1999	50137	Leciñena	326	276	50	26	126	74	100
1999	50138	Lechón	17	16	1	4	4	3	6
1999	50139	Letux	190	144	46	23	66	42	59
1999	50140	Litago	71	47	24	5	29	18	19
1999	50141	Lituénigo	163	114	49	21	72	22	48
1999	50142	Lobera de Onsella	44	34	10	2	11	5	26
1999	50143	Longares	424	305	119	111	173	97	43
1999	50144	Longás	20	18	2	0	6	3	11
1999	50146	Lucena de Jalón	75	63	12	14	36	8	17
1999	50147	Luceni	177	146	31	20	74	35	48
1999	50148	Luesia	93	86	7	9	47	14	23
1999	50149	Luesma	7	7	0	1	2	3	1
1999	50150	Lumpiaque	254	186	68	25	88	56	85
1999	50151	Luna	347	294	53	47	110	70	120
1999	50152	Maella	994	643	351	171	376	188	259
1999	50153	Magallón	660	494	166	138	246	123	153
1999	50154	Mainar	39	37	2	10	13	7	9
1999	50155	Malanquilla	35	31	4	5	6	14	10
1999	50156	Maleján	0	0	0	0	0	0	0
1999	50157	Malón	201	153	48	59	60	38	44
1999	50159	Maluenda	365	275	90	65	119	82	99
1999	50160	Mallén	384	327	57	59	150	89	86
1999	50161	Manchones	63	56	7	4	16	11	32
1999	50162	Mara	130	92	38	24	38	35	33
1999	50163	María de Huerva	71	59	12	15	31	13	12
1999	50164	Mediana de Aragón	115	95	20	8	62	21	24
1999	50165	Mequinenza	867	571	296	185	294	206	182
1999	50166	Mesones de Isuela	164	136	28	20	66	39	39
1999	50167	Mezalocha	133	100	33	21	54	28	30
1999	50168	Mianos	17	15	2	5	2	6	4
1999	50169	Miedes de Aragón	262	204	58	68	91	45	58
1999	50170	Monegrillo	206	166	40	9	96	55	46
1999	50171	Moneva	67	50	17	8	28	22	9
1999	50172	Monreal de Ariza	91	72	19	24	32	25	10
1999	50173	Monterde	84	71	13	11	26	29	18
1999	50174	Montón	62	49	13	19	9	26	8
1999	50175	Morata de Jalón	596	449	147	92	198	121	185
1999	50176	Morata de Jiloca	143	113	30	21	43	35	44
1999	50177	Morés	178	150	28	13	62	26	77
1999	50178	Moros	356	274	82	53	106	76	121
1999	50179	Moyuela	102	87	15	5	41	25	31
1999	50180	Mozota	19	15	4	1	3	4	11
1999	50181	Muel	377	283	94	72	132	70	103
1999	50182	Muela (La)	400	284	116	79	164	68	89
1999	50183	Munébrega	311	230	81	66	111	52	82
1999	50184	Murero	68	59	9	7	20	14	27
1999	50185	Murillo de Gállego	46	36	10	4	15	9	18
1999	50186	Navardún	39	28	11	4	13	9	13
1999	50187	Nigüella	41	34	7	2	10	16	13
1999	50188	Nombrevilla	21	18	3	3	3	8	7
1999	50189	Nonaspe	363	248	115	49	140	71	103
1999	50190	Novallas	296	235	61	40	89	58	109
1999	50191	Novillas	263	227	36	31	132	60	40
1999	50192	Nuévalos	22	21	1	3	10	4	5
1999	50193	Nuez de Ebro	40	38	2	6	7	13	14
1999	50194	Olvés	107	82	25	23	39	23	22
1999	50195	Orcajo	68	46	22	5	18	20	25
1999	50196	Orera	113	85	28	20	45	18	30
1999	50197	Orés	71	60	11	10	24	9	28
1999	50198	Oseja	39	25	14	2	10	14	13
1999	50199	Osera de Ebro	39	31	8	4	16	11	8
1999	50200	Paniza	531	367	164	119	239	75	98
1999	50201	Paracuellos de Jiloca	235	170	65	30	89	39	77
1999	50202	Paracuellos de la Ribera	182	134	48	21	48	39	74
1999	50203	Pastriz	110	93	17	10	29	30	41
1999	50204	Pedrola	422	331	91	46	157	112	107
1999	50205	Pedrosas (Las)	28	25	3	4	10	2	12
1999	50206	Perdiguera	120	100	20	20	46	22	32
1999	50207	Piedratajada	23	22	1	2	14	3	4
1999	50208	Pina de Ebro	541	434	107	52	166	131	192
1999	50209	Pinseque	175	148	27	11	64	45	55
1999	50210	Pintanos (Los)	48	38	10	4	12	11	21
1999	50211	Plasencia de Jalón	139	101	38	28	53	26	32
1999	50212	Pleitas	22	16	6	2	8	5	7
1999	50213	Plenas	82	68	14	8	20	22	32
1999	50214	Pomer	3	3	0	1	1	0	1
1999	50215	Pozuel de Ariza	9	7	2	1	1	4	3
1999	50216	Pozuelo de Aragón	133	107	26	30	46	34	23
1999	50217	Pradilla de Ebro	143	119	24	16	55	34	38
1999	50218	Puebla de Albortón	71	53	18	8	27	23	13
1999	50219	Puebla de Alfindén (La)	73	59	14	5	25	16	27
1999	50220	Puendeluna	20	16	4	3	8	1	8
1999	50221	Purujosa	5	5	0	0	2	1	2
1999	50222	Quinto	284	244	40	35	124	65	60
1999	50223	Remolinos	132	108	24	14	52	37	29
1999	50224	Retascón	58	45	13	3	15	23	17
1999	50225	Ricla	927	674	253	236	347	173	171
1999	50227	Romanos	35	31	4	3	16	13	3
1999	50228	Rueda de Jalón	301	208	93	52	118	76	55
1999	50229	Ruesca	47	38	9	15	14	8	10
1999	50230	Sádaba	273	216	57	39	119	51	64
1999	50231	Salillas de Jalón	52	42	10	7	18	12	15
1999	50232	Salvatierra de Esca	37	29	8	2	16	6	13
1999	50233	Samper del Salz	19	13	6	3	8	2	6
1999	50234	San Martín de la Virgen de Moncayo	28	23	5	2	13	5	8
1999	50235	San Mateo de Gállego	254	219	35	18	103	55	78
1999	50236	Santa Cruz de Grío	207	135	72	28	79	36	64
1999	50237	Santa Cruz de Moncayo	55	43	12	5	24	9	17
1999	50238	Santa Eulalia de Gállego	28	23	5	5	6	9	8
1999	50239	Santed	34	25	9	2	16	6	10
1999	50240	Sástago	330	245	85	65	125	76	64
1999	50241	Saviñán	220	166	54	25	61	48	86
1999	50242	Sediles	38	30	8	1	11	13	13
1999	50243	Sestrica	308	238	70	49	91	75	93
1999	50244	Sierra de Luna	66	54	12	7	14	18	27
1999	50245	Sigüés	41	33	8	2	15	7	17
1999	50246	Sisamón	19	18	1	3	9	6	1
1999	50247	Sobradiel	95	84	11	6	30	28	31
1999	50248	Sos del Rey Católico	299	232	67	30	107	73	89
1999	50249	Tabuenca	363	261	102	62	127	98	76
1999	50250	Talamantes	18	15	3	2	3	6	7
1999	50251	Tarazona	1114	935	179	102	336	310	366
1999	50252	Tauste	1467	1216	251	193	659	264	351
1999	50253	Terrer	174	138	36	31	51	43	49
1999	50254	Tierga	137	118	19	22	52	33	30
1999	50255	Tobed	161	120	41	21	49	49	42
1999	50256	Torralba de los Frailes	47	37	10	2	28	10	7
1999	50257	Torralba de Ribota	179	126	53	14	44	53	68
1999	50258	Torralbilla	19	18	1	1	5	4	9
1999	50259	Torrehermosa	20	20	0	5	5	7	3
1999	50260	Torrelapaja	14	10	4	0	3	7	4
1999	50261	Torrellas	47	41	6	0	9	9	29
1999	50262	Torres de Berrellén	239	184	55	22	94	55	68
1999	50263	Torrijo de la Cañada	150	124	26	8	42	30	70
1999	50264	Tosos	181	130	51	16	63	43	59
1999	50265	Trasmoz	52	42	10	1	16	16	19
1999	50266	Trasobares	141	110	31	18	43	36	44
1999	50267	Uncastillo	117	100	17	11	44	39	23
1999	50268	Undués de Lerda	21	18	3	1	7	4	9
1999	50269	Urrea de Jalón	116	87	29	19	37	34	26
1999	50270	Urriés	26	21	5	1	3	4	18
1999	50271	Used	165	112	53	24	60	36	45
1999	50272	Utebo	148	132	16	28	42	45	33
1999	50273	Valdehorna	85	56	29	12	27	17	29
1999	50274	Val de San Martín	38	27	11	7	10	11	10
1999	50275	Valmadrid	33	27	6	7	12	4	10
1999	50276	Valpalmas	50	37	13	2	17	12	19
1999	50277	Valtorres	36	24	12	4	13	5	14
1999	50278	Velilla de Ebro	42	37	5	11	16	11	4
1999	50279	Velilla de Jiloca	56	43	13	9	16	7	24
1999	50280	Vera de Moncayo	253	188	65	38	101	33	81
1999	50281	Vierlas	35	27	8	2	13	7	13
1999	50282	Vilueña (La)	118	89	29	23	33	21	41
1999	50283	Villadoz	34	29	5	3	6	14	11
1999	50284	Villafeliche	76	54	22	12	16	16	32
1999	50285	Villafranca de Ebro	163	130	33	15	53	43	52
1999	50286	Villalba de Perejil	56	47	9	3	30	15	8
1999	50287	Villalengua	174	125	49	25	69	39	41
1999	50288	Villanueva de Gállego	192	161	31	20	74	38	60
1999	50289	Villanueva de Jiloca	54	34	20	1	15	17	21
1999	50290	Villanueva de Huerva	207	182	25	24	62	48	73
1999	50291	Villar de los Navarros	84	64	20	7	21	32	24
1999	50292	Villarreal de Huerva	36	31	5	3	9	16	8
1999	50293	Villarroya de la Sierra	401	299	102	47	133	89	132
1999	50294	Villarroya del Campo	26	22	4	0	12	7	7
1999	50295	Vistabella	23	15	8	2	5	7	9
1999	50296	Zaida (La)	87	73	14	12	25	31	19
1999	50297	Zaragoza	2255	1809	446	245	757	556	697
1999	50298	Zuera	616	526	90	86	224	121	185
1999	50901	Biel	47	40	7	4	12	13	18
1999	50902	Marracos	17	17	0	2	7	7	1