Año	Código del municipio	Nombre del municipio	Unidades ganaderas	Ganado bovino (cabezas)	Ganado bovino-vacas lecheras (cabezas)	Ganado bovino-resto bovino (cabezas)	Ganado ovino (cabezas)	Ganado caprino (cabezas)	Ganado porcino (cabezas)	Ganado porcino-cerdas madres (cabezas)	Ganado porcino-resto porcino (cabezas)	Ganado equino (cabezas)	Miles de aves	Conejas madres (cabezas)
1989	22001	Abiego	1486	2	2	0	2507	81	4266	403	3863	1	1	38
1989	22002	Abizanda	249	12	6	6	1664	5	342	112	230	0	0	68
1989	22003	Adahuesca	346	4	4	0	1926	11	16	15	1	0	20	50
1989	22004	Agüero	186	7	0	7	1364	215	11	2	9	27	0	2
1989	22006	Aísa	337	167	0	167	1823	173	29	0	29	0	0	56
1989	22007	Albalate de Cinca	4983	3065	458	2607	5010	45	6214	121	6093	0	148	335
1989	22008	Albalatillo	405	220	0	220	0	0	707	0	707	0	15	0
1989	22009	Albelda	11310	1838	154	1684	7663	184	27896	1885	26011	1	67	418
1989	22011	Albero Alto	533	0	0	0	0	0	773	15	758	0	42	12
1989	22012	Albero Bajo	141	0	0	0	790	22	175	80	95	0	1	12
1989	22013	Alberuela de Tubo	1785	583	136	447	2459	13	3846	159	3687	0	8	25
1989	22014	Alcalá de Gurrea	328	0	0	0	2718	62	77	25	52	1	5	0
1989	22015	Alcalá del Obispo	1355	198	19	179	2985	2	3392	144	3248	0	49	0
1989	22016	Alcampell	5908	1828	25	1803	3240	38	16713	1580	15133	13	43	139
1989	22017	Alcolea de Cinca	11304	1200	113	1087	6431	30	15699	78	15621	4	321	455
1989	22018	Alcubierre	4051	237	21	216	2689	18	12370	286	12084	0	0	0
1989	22019	Alerre	48	0	0	0	484	0	0	0	0	0	0	0
1989	22020	Alfántega	449	10	7	3	260	0	1389	17	1372	0	0	2
1989	22021	Almudévar	1833	486	107	379	10304	266	333	103	230	0	57	24
1989	22022	Almunia de San Juan	1869	899	139	760	2782	2	2685	34	2651	0	52	0
1989	22023	Almuniente	2308	369	155	214	6154	10	4438	144	4294	0	15	0
1989	22024	Alquézar	309	6	4	2	1589	110	454	196	258	13	1	96
1989	22025	Altorricón	14747	5806	87	5719	4064	26	38175	2595	35580	2	109	70
1989	22027	Angüés	1872	1000	0	1000	502	0	3455	456	2999	0	12	3
1989	22028	Ansó	858	330	0	330	5862	92	10	0	10	0	0	4
1989	22029	Antillón	253	80	0	80	2096	29	10	0	10	0	0	6
1989	22032	Aragüés del Puerto	315	359	0	359	268	66	13	0	13	15	0	28
1989	22035	Arén	2311	140	70	70	11526	242	3438	695	2743	2	1	168
1989	22036	Argavieso	65	11	6	5	230	0	721	10	711	0	0	2
1989	22037	Arguis	31	0	0	0	295	18	0	0	0	0	0	0
1989	22039	Ayerbe	6940	38	25	13	1054	110	2908	906	2002	1	201	48
1989	22040	Azanuy-Alins	657	180	40	140	1332	49	770	55	715	0	30	62
1989	22041	Azara	350	7	7	0	0	4	1529	500	1029	0	0	4
1989	22042	Azlor	305	28	18	10	700	110	895	354	541	0	0	11
1989	22043	Baells	469	0	0	0	574	19	1418	73	1345	0	0	23
1989	22044	Bailo	1179	276	0	276	8545	390	391	120	271	1	1	73
1989	22045	Baldellou	858	0	0	0	1559	39	1393	3	1390	0	0	120
1989	22046	Ballobar	1685	162	4	158	8342	59	2458	41	2417	0	1	513
1989	22047	Banastás	0	0	0	0	0	0	0	0	0	0	0	0
1989	22048	Barbastro	5194	2318	185	2133	8615	148	9865	913	8952	4	9	413
1989	22049	Barbués	132	63	39	24	0	0	459	131	328	0	0	0
1989	22050	Barbuñales	12	17	0	17	0	0	8	0	8	0	0	0
1989	22051	Bárcabo	312	48	2	46	2210	5	312	70	242	1	0	158
1989	22052	Belver de Cinca	7286	3209	177	3032	7755	0	16674	237	16437	0	0	120
1989	22053	Benabarre	4556	30	20	10	7968	535	11258	1991	9267	0	99	737
1989	22054	Benasque	699	520	139	381	2736	27	0	0	0	60	0	30
1989	22055	Berbegal	1227	96	55	41	1859	0	1132	0	1132	0	90	0
1989	22057	Bielsa	648	557	0	557	2416	310	1	0	1	32	1	145
1989	22058	Bierge	607	0	0	0	2141	75	736	125	611	3	28	21
1989	22059	Biescas	1461	1206	8	1198	5307	117	89	3	86	1	1	95
1989	22060	Binaced	6213	3560	128	3432	5351	162	11331	1087	10244	3	112	344
1989	22061	Binéfar	4489	3507	147	3360	1508	7	12241	1553	10688	0	0	534
1989	22062	Bisaurri	1261	1124	30	1094	4592	67	0	0	0	7	0	225
1989	22063	Biscarrués	414	0	0	0	2766	97	23	19	4	0	16	118
1989	22064	Blecua y Torres	1199	0	0	0	3538	47	3273	190	3083	0	0	0
1989	22066	Boltaña	890	492	44	448	2960	388	657	141	516	1	0	21
1989	22067	Bonansa	818	216	30	186	5577	226	520	115	405	1	0	378
1989	22068	Borau	282	142	0	142	1680	103	2	0	2	0	0	32
1989	22069	Broto	1397	1484	0	1484	2379	260	54	0	54	3	1	120
1989	22072	Caldearenas	426	4	1	3	3182	46	225	147	78	1	0	96
1989	22074	Campo	2083	216	170	46	3846	25	1412	154	1258	2	142	113
1989	22075	Camporrells	1669	0	0	0	1115	33	5238	619	4619	0	0	501
1989	22076	Canal de Berdún	771	293	0	293	4917	165	137	35	102	2	1	52
1989	22077	Candasnos	3678	0	0	0	5025	163	9920	340	9580	0	15	580
1989	22078	Canfranc	35	47	19	28	0	0	0	0	0	0	0	0
1989	22079	Capdesaso	268	125	91	34	926	18	209	0	209	0	0	8
1989	22080	Capella	2185	80	0	80	1716	4	6575	872	5703	0	41	183
1989	22081	Casbas de Huesca	749	79	44	35	1373	68	1958	261	1697	1	1	17
1989	22082	Castejón del Puente	1058	0	0	0	2364	62	2552	251	2301	0	0	0
1989	22083	Castejón de Monegros	1414	0	0	0	5718	179	2931	665	2266	0	10	576
1989	22084	Castejón de Sos	670	577	0	577	2656	31	0	0	0	2	0	66
1989	22085	Castelflorite	268	49	19	30	470	25	1115	27	1088	0	0	3
1989	22086	Castiello de Jaca	276	20	2	18	1016	64	499	90	409	2	3	26
1989	22087	Castigaleu	235	0	0	0	904	36	670	174	496	0	0	23
1989	22088	Castillazuelo	136	97	11	86	90	0	354	43	311	0	0	0
1989	22089	Castillonroy	1837	280	27	253	1205	6	5321	297	5024	0	10	346
1989	22090	Colungo	135	0	0	0	341	80	437	136	301	6	0	323
1989	22094	Chalamera	1265	809	98	711	890	9	2286	75	2211	1	20	0
1989	22095	Chía	350	358	12	346	679	53	0	0	0	8	0	142
1989	22096	Chimillas	0	0	0	0	0	0	0	0	0	0	0	0
1989	22099	Esplús	7768	5182	55	5127	6916	5	15662	418	15244	0	3	347
1989	22102	Estada	1388	140	0	140	187	4	3241	324	2917	1	52	250
1989	22103	Estadilla	3986	1688	94	1594	4180	78	10137	876	9261	2	1	873
1989	22105	Estopiñán del Castillo	667	530	0	530	2969	237	749	198	551	2	1	68
1989	22106	Fago	64	82	0	82	0	23	0	0	0	0	0	3
1989	22107	Fanlo	389	201	0	201	2151	172	0	0	0	4	0	8
1989	22109	Fiscal	878	825	15	810	1855	93	229	83	146	2	0	35
1989	22110	Fonz	13394	1663	54	1609	3026	225	16035	1227	14808	5	375	524
1989	22111	Foradada del Toscar	2078	430	203	227	7520	156	1437	212	1225	2	88	99
1989	22112	Fraga	37273	2888	63	2825	11234	122	55321	3677	51644	9	991	180
1989	22113	Fueva (La)	4192	775	116	659	8095	232	13342	2342	11000	13	3	509
1989	22114	Gistaín	824	419	10	409	4585	358	3	0	3	43	1	84
1989	22115	Grado (El)	1193	110	10	100	2270	31	3418	326	3092	8	4	86
1989	22116	Grañén	4990	2596	176	2420	11204	49	5715	338	5377	0	55	502
1989	22117	Graus	4554	442	71	371	9661	292	9163	1777	7386	3	150	657
1989	22119	Gurrea de Gállego	2285	597	26	571	11677	127	1730	47	1683	3	35	24
1989	22122	Hoz de Jaca	213	245	0	245	450	0	2	0	2	1	0	430
1989	22124	Huerto	607	25	8	17	1240	50	1516	134	1382	0	11	10
1989	22125	Huesca	8582	1088	130	958	7382	75	20573	2858	17715	2	250	13
1989	22126	Ibieca	183	0	0	0	1775	12	2	0	2	0	0	24
1989	22127	Igriés	364	32	15	17	845	0	820	60	760	0	0	0
1989	22128	Ilche	885	349	20	329	2912	24	1722	158	1564	0	0	0
1989	22129	Isábena	739	118	10	108	4783	76	955	297	658	1	1	102
1989	22130	Jaca	4313	800	141	659	22222	678	5221	780	4441	75	11	613
1989	22131	Jasa	117	132	0	132	82	43	6	0	6	4	0	11
1989	22133	Labuerda	105	54	24	30	437	0	18	8	10	1	0	119
1989	22135	Laluenga	609	6	5	1	1148	3	2161	469	1692	0	0	2
1989	22136	Lalueza	6063	1896	502	1394	11592	179	12732	1087	11645	0	0	2
1989	22137	Lanaja	4599	722	226	496	9091	138	11423	647	10776	1	0	0
1989	22139	Laperdiguera	601	455	0	455	0	0	1405	75	1330	0	0	13
1989	22141	Lascellas-Ponzano	245	192	9	183	465	7	424	79	345	0	0	6
1989	22142	Lascuarre	1033	0	0	0	3865	37	2047	397	1650	0	16	72
1989	22143	Laspaúles	1676	959	0	959	9498	154	0	0	0	27	1	144
1989	22144	Laspuña	230	149	0	149	792	91	71	21	50	6	1	119
1989	22149	Loarre	1271	38	5	33	3180	372	599	302	297	1	101	112
1989	22150	Loporzano	2728	1	1	0	5402	357	836	725	111	0	144	110
1989	22151	Loscorrales	309	0	0	0	1092	15	628	28	600	0	0	8
1989	22155	Monesma y Cajigar	553	0	0	0	3709	73	887	254	633	0	1	94
1989	22156	Monflorite-Lascasas	1183	230	0	230	1261	33	2637	440	2197	0	35	15
1989	22157	Montanuy	2824	1434	60	1374	16333	265	200	0	200	32	1	229
1989	22158	Monzón	16927	7265	678	6587	13750	68	33773	2271	31502	3	347	728
1989	22160	Naval	1151	145	4	141	1937	45	916	159	757	6	98	10
1989	22162	Novales	653	10	0	10	21	0	1967	240	1727	0	22	0
1989	22163	Nueno	1071	0	0	0	4179	137	0	0	0	1	46	0
1989	22164	Olvena	198	0	0	0	214	0	734	303	431	0	0	189
1989	22165	Ontiñena	1002	259	55	204	6160	77	442	234	208	0	0	122
1989	22167	Osso de Cinca	6169	1489	334	1155	1271	78	7277	66	7211	0	107	8
1989	22168	Palo	32	0	0	0	187	10	46	17	29	1	0	11
1989	22170	Panticosa	321	261	5	256	1156	91	0	0	0	0	0	38
1989	22172	Peñalba	2489	449	0	449	4833	61	1804	200	1604	0	169	0
1989	22173	Peñas de Riglos (Las)	525	112	0	112	3595	368	71	67	4	0	0	46
1989	22174	Peralta de Alcofea	2150	150	0	150	8474	69	3730	203	3527	0	22	0
1989	22175	Peralta de Calasanz	1472	1130	0	1130	3131	200	1627	270	1357	1	24	88
1989	22176	Peraltilla	193	110	0	110	234	14	431	181	250	0	0	95
1989	22177	Perarrúa	256	0	0	0	176	0	1020	282	738	1	0	109
1989	22178	Pertusa	674	0	0	0	942	15	2598	396	2202	0	0	4
1989	22181	Piracés	204	0	0	0	0	0	1142	281	861	0	0	2
1989	22182	Plan	761	656	12	644	2279	594	0	0	0	26	0	45
1989	22184	Poleñino	1008	378	0	378	678	0	1769	168	1601	0	32	0
1989	22186	Pozán de Vero	297	12	12	0	62	0	1168	229	939	0	0	30
1989	22187	Puebla de Castro (La)	1481	0	0	0	684	2	1985	15	1970	2	117	29
1989	22188	Puente de Montañana	278	200	0	200	1625	90	134	34	100	1	0	21
1989	22189	Puértolas	940	273	10	263	2937	400	1288	17	1271	21	0	83
1989	22190	Pueyo de Araguás (El)	558	317	18	299	3065	198	292	80	212	3	0	64
1989	22193	Pueyo de Santa Cruz	551	102	2	100	1040	0	1124	253	871	0	0	1
1989	22195	Quicena	989	328	2	326	697	0	52	20	32	59	70	6
1989	22197	Robres	7773	781	39	742	6696	2	17885	511	17374	0	186	3
1989	22199	Sabiñánigo	2435	674	37	637	9928	227	2504	231	2273	4	33	179
1989	22200	Sahún	595	661	53	608	1067	57	0	0	0	7	0	55
1989	22201	Salas Altas	281	0	0	0	107	7	663	74	589	0	9	18
1989	22202	Salas Bajas	182	0	0	0	0	0	566	115	451	0	0	16
1989	22203	Salillas	488	30	0	30	0	4	1672	85	1587	0	0	11
1989	22204	Sallent de Gállego	724	751	16	735	1777	99	17	0	17	0	0	38
1989	22205	San Esteban de Litera	5967	3150	57	3093	4175	140	14450	1987	12463	4	1	186
1989	22206	Sangarrén	2308	524	7	517	539	4	4388	30	4358	0	80	2
1989	22207	San Juan de Plan	825	605	0	605	4034	174	3	0	3	30	0	64
1989	22208	Santa Cilia	423	0	0	0	3580	94	175	65	110	0	0	69
1989	22209	Santa Cruz de la Serós	256	7	5	2	2174	56	90	27	63	1	0	37
1989	22212	Santaliestra y San Quílez	1070	3	3	0	0	0	1231	71	1160	0	103	35
1989	22213	Sariñena	7933	2387	423	1964	21407	312	10272	969	9303	2	116	81
1989	22214	Secastilla	204	10	4	6	1668	22	100	37	63	2	0	64
1989	22215	Seira	236	230	17	213	431	268	0	0	0	9	0	19
1989	22217	Sena	965	219	164	55	6680	226	42	36	6	0	8	8
1989	22218	Senés de Alcubierre	193	0	0	0	1430	0	101	87	14	0	0	3
1989	22220	Sesa	628	310	23	287	419	15	651	199	452	0	46	27
1989	22221	Sesué	305	411	85	326	31	0	0	0	0	1	0	19
1989	22222	Siétamo	1445	300	0	300	3963	159	2741	220	2521	1	7	32
1989	22223	Sopeira	475	117	3	114	2464	203	600	103	497	1	0	48
1989	22225	Tamarite de Litera	23263	8576	1339	7237	10736	809	55817	3761	52056	51	94	389
1989	22226	Tardienta	753	429	77	352	4848	156	39	22	17	1	1	16
1989	22227	Tella-Sin	303	238	0	238	996	374	0	0	0	14	0	82
1989	22228	Tierz	143	40	36	4	833	16	54	30	24	0	0	2
1989	22229	Tolva	1683	0	0	0	2567	97	5995	926	5069	0	0	97
1989	22230	Torla-Ordesa	1234	1053	10	1043	969	37	850	0	850	5	5	3
1989	22232	Torralba de Aragón	325	68	52	16	2278	41	92	34	58	0	0	200
1989	22233	Torre la Ribera	404	118	39	79	2571	57	257	61	196	2	0	62
1989	22234	Torrente de Cinca	1445	0	0	0	900	20	3556	155	3401	0	36	182
1989	22235	Torres de Alcanadre	419	0	0	0	178	15	1769	373	1396	0	0	9
1989	22236	Torres de Barbués	1744	237	126	111	1950	18	5231	375	4856	1	0	0
1989	22239	Tramaced	1871	687	100	587	3	0	3781	107	3674	4	63	2
1989	22242	Valfarta	334	0	0	0	746	26	70	70	0	0	32	100
1989	22243	Valle de Bardají	383	221	140	81	1433	118	266	51	215	0	0	24
1989	22244	Valle de Lierp	277	83	32	51	1459	120	267	72	195	1	0	32
1989	22245	Velilla de Cinca	61	5	5	0	490	0	10	4	6	0	0	10
1989	22246	Beranuy	736	24	11	13	3536	108	1252	163	1089	11	5	61
1989	22247	Viacamp y Litera	509	306	0	306	741	7	1088	15	1073	0	0	20
1989	22248	Vicién	386	260	0	260	2684	30	42	7	35	0	0	0
1989	22249	Villanova	148	152	57	95	298	12	0	0	0	0	0	1
1989	22250	Villanúa	193	224	47	177	186	150	1	0	1	0	0	40
1989	22251	Villanueva de Sigena	1507	893	40	853	9897	66	268	60	208	0	3	0
1989	22252	Yebra de Basa	241	158	13	145	1183	16	35	1	34	0	0	22
1989	22253	Yésero	61	74	2	72	0	0	8	0	8	1	0	16
1989	22254	Zaidín	11059	1031	3	1028	3537	0	24253	579	23674	0	357	0
1989	22901	Valle de Hecho	2174	1853	107	1746	7290	559	174	11	163	13	1	108
1989	22902	Puente la Reina de Jaca	1170	15	6	9	8456	115	1362	226	1136	1	1	53
1989	22903	San Miguel del Cinca	3412	1151	117	1034	5802	25	6197	423	5774	0	82	650
1989	22904	Sotonera (La)	2150	88	3	85	8386	618	7012	1519	5493	2	2	139
1989	22905	Lupiñén-Ortilla	1190	170	72	98	6358	11	152	86	66	0	51	64
1989	22906	Santa María de Dulcis	189	6	6	0	1404	54	72	64	8	2	0	100
1989	22907	Aínsa-Sobrarbe	1487	397	34	363	6711	68	2261	832	1429	0	8	99
1989	22908	Hoz y Costeán	410	183	4	179	2023	36	256	118	138	2	0	84
1989	22909	Vencillón	6317	3147	67	3080	4246	66	16233	858	15375	7	0	138
1989	44001	Ababuj	439	30	8	22	3649	49	187	53	134	2	0	42
1989	44002	Abejuela	116	0	0	0	1119	0	0	0	0	6	0	4
1989	44003	Aguatón	140	0	0	0	1336	9	14	2	12	0	0	8
1989	44004	Aguaviva	1973	52	12	40	2681	58	5219	573	4646	6	0	577
1989	44005	Aguilar del Alfambra	332	37	23	14	2536	17	136	46	90	0	0	442
1989	44006	Alacón	2396	0	0	0	6344	106	6425	758	5667	29	9	52
1989	44007	Alba	1014	20	9	11	9348	77	160	69	91	5	0	37
1989	44008	Albalate del Arzobispo	1247	0	0	0	7455	358	624	202	422	9	16	679
1989	44009	Albarracín	789	38	13	25	6757	460	42	29	13	11	0	99
1989	44010	Albentosa	469	22	0	22	2615	296	522	3	519	9	0	57
1989	44011	Alcaine	258	0	0	0	2534	29	0	0	0	2	0	2
1989	44012	Alcalá de la Selva	922	516	0	516	5276	56	34	0	34	20	1	369
1989	44013	Alcañiz	4777	360	128	232	19296	842	7769	701	7068	3	79	3004
1989	44014	Alcorisa	2226	193	108	85	6300	78	5025	426	4599	8	1	455
1989	44016	Alfambra	1598	63	30	33	14023	14	657	200	457	1	1	260
1989	44017	Aliaga	990	243	0	243	7400	82	256	29	227	15	1	125
1989	44018	Almohaja	144	0	0	0	1264	164	3	0	3	0	0	2
1989	44019	Alobras	283	0	0	0	2523	51	39	9	30	16	0	19
1989	44020	Alpeñés	204	0	0	0	1910	0	5	0	5	12	0	65
1989	44021	Allepuz	938	110	0	110	7545	106	171	118	53	17	0	65
1989	44022	Alloza	257	0	0	0	2260	126	20	0	20	4	1	61
1989	44023	Allueva	38	0	0	0	378	0	0	0	0	0	0	0
1989	44024	Anadón	125	0	0	0	1199	9	8	3	5	0	0	5
1989	44025	Andorra	1104	0	0	0	6429	189	1401	1	1400	2	1	110
1989	44026	Arcos de las Salinas	371	0	0	0	3525	52	13	0	13	9	0	137
1989	44027	Arens de Lledó	146	0	0	0	416	22	123	6	117	0	6	218
1989	44028	Argente	728	4	2	2	5002	11	737	42	695	0	1	78
1989	44029	Ariño	72	1	1	0	544	118	0	0	0	3	0	8
1989	44031	Azaila	731	115	0	115	1493	104	1750	0	1750	0	0	0
1989	44032	Bádenas	130	0	0	0	1197	90	2	0	2	0	0	4
1989	44033	Báguena	723	5	3	2	1238	6	2943	479	2464	30	0	98
1989	44034	Bañón	861	0	0	0	4128	0	1637	222	1415	0	0	52
1989	44035	Barrachina	241	0	0	0	2127	9	114	16	98	0	0	50
1989	44036	Bea	140	0	0	0	1142	242	0	0	0	1	0	4
1989	44037	Beceite	1898	8	4	4	1156	159	1589	167	1422	8	193	232
1989	44038	Belmonte de San José	449	0	0	0	528	254	1350	180	1170	13	0	0
1989	44039	Bello	796	117	0	117	5644	67	685	205	480	3	1	214
1989	44040	Berge	245	0	0	0	1615	73	276	100	176	12	0	28
1989	44041	Bezas	60	0	0	0	406	140	9	0	9	2	0	3
1989	44042	Blancas	468	0	0	0	3577	30	447	147	300	0	0	37
1989	44043	Blesa	416	0	0	0	3983	76	11	0	11	5	0	3
1989	44044	Bordón	1006	11	0	11	2666	399	2280	152	2128	16	1	90
1989	44045	Bronchales	525	90	44	46	3495	121	214	162	52	2	0	30
1989	44046	Bueña	557	0	0	0	4953	64	125	58	67	3	0	38
1989	44047	Burbáguena	277	0	0	0	930	0	972	259	713	7	0	715
1989	44048	Cabra de Mora	178	0	0	0	1444	102	53	28	25	7	0	45
1989	44049	Calaceite	1731	0	0	0	3038	116	2564	112	2452	6	60	886
1989	44050	Calamocha	7086	188	104	84	20054	202	18635	2139	16496	26	27	1105
1989	44051	Calanda	4145	124	39	85	3802	97	7120	5334	1786	6	75	700
1989	44052	Calomarde	229	0	0	0	2148	66	6	6	0	1	0	163
1989	44053	Camañas	583	0	0	0	5485	56	97	27	70	0	0	20
1989	44054	Camarena de la Sierra	174	0	0	0	1600	0	10	5	5	11	0	71
1989	44055	Camarillas	397	0	0	0	2960	41	292	73	219	0	1	253
1989	44056	Caminreal	1532	181	32	149	6405	5	2723	470	2253	23	1	574
1989	44059	Cantavieja	1829	552	53	499	5619	235	2321	1079	1242	48	0	9
1989	44060	Cañada de Benatanduz	472	170	0	170	3024	33	191	53	138	7	0	40
1989	44061	Cañada de Verich (La)	308	0	0	0	49	0	924	124	800	1	0	0
1989	44062	Cañada Vellida	261	0	0	0	2490	28	18	0	18	0	0	36
1989	44063	Cañizar del Olivar	84	25	0	25	677	9	4	1	3	3	0	23
1989	44064	Cascante del Río	297	0	0	0	2717	0	34	14	20	16	0	22
1989	44065	Castejón de Tornos	211	0	0	0	853	28	495	184	311	4	0	29
1989	44066	Castel de Cabra	406	0	0	0	2559	46	432	12	420	9	1	64
1989	44067	Castelnou	280	0	0	0	2694	48	6	0	6	1	0	24
1989	44068	Castelserás	2119	120	0	120	1387	110	7013	525	6488	0	12	29
1989	44070	Castellar (El)	336	38	15	23	2562	68	132	32	100	9	0	53
1989	44071	Castellote	1581	26	2	24	6351	211	2852	96	2756	34	13	1415
1989	44074	Cedrillas	1778	478	111	367	5833	214	3265	659	2606	3	1	784
1989	44075	Celadas	1043	0	0	0	9595	37	245	37	208	0	1	143
1989	44076	Cella	3757	687	261	426	13912	366	6555	1353	5202	54	4	1122
1989	44077	Cerollera (La)	449	0	0	0	140	0	1300	200	1100	9	0	0
1989	44080	Codoñera (La)	1296	0	0	0	940	29	3478	174	3304	0	18	0
1989	44082	Corbalán	310	41	0	41	2441	45	79	25	54	0	0	33
1989	44084	Cortes de Aragón	132	0	0	0	1232	7	10	0	10	1	0	3
1989	44085	Cosa	585	0	0	0	5048	21	304	60	244	0	0	42
1989	44086	Cretas	1322	60	0	60	1319	37	2804	741	2063	4	28	1108
1989	44087	Crivillén	261	0	0	0	2561	21	0	0	0	0	0	49
1989	44088	Cuba (La)	237	1	0	1	78	3	499	343	156	6	0	380
1989	44089	Cubla	221	0	0	0	2079	0	15	9	6	6	0	63
1989	44090	Cucalón	203	0	0	0	1806	165	4	4	0	0	0	27
1989	44092	Cuervo (El)	65	0	0	0	487	9	16	0	16	13	0	59
1989	44093	Cuevas de Almudén	108	0	0	0	913	21	32	0	32	0	0	54
1989	44094	Cuevas Labradas	290	3	0	3	2365	4	207	80	127	0	0	54
1989	44096	Ejulve	581	345	0	345	3233	275	16	5	11	6	0	121
1989	44097	Escorihuela	637	5	2	3	5656	42	121	40	81	4	1	103
1989	44099	Escucha	451	130	0	130	3600	54	32	22	10	1	0	828
1989	44100	Estercuel	396	0	0	0	2818	17	506	180	326	3	0	31
1989	44101	Ferreruela de Huerva	151	0	0	0	436	0	0	0	0	0	15	14
1989	44102	Fonfría	224	0	0	0	2077	61	15	15	0	0	0	4
1989	44103	Formiche Alto	314	0	0	0	1269	53	572	3	569	3	0	302
1989	44105	Fórnoles	105	0	0	0	815	18	18	16	2	10	0	430
1989	44106	Fortanete	889	300	0	300	3835	37	1329	355	974	10	0	859
1989	44107	Foz-Calanda	461	0	0	0	1518	96	2158	358	1800	3	10	0
1989	44108	Fresneda (La)	1116	44	0	44	677	16	2321	127	2194	5	50	102
1989	44109	Frías de Albarracín	425	25	0	25	3855	80	31	10	21	9	0	1
1989	44110	Fuenferrada	178	0	0	0	1693	2	17	0	17	0	0	55
1989	44111	Fuentes Calientes	534	42	27	15	4723	20	70	8	62	0	0	67
1989	44112	Fuentes Claras	1887	117	47	70	4871	28	5316	957	4359	14	1	410
1989	44113	Fuentes de Rubielos	56	1	0	1	314	65	17	2	15	19	0	17
1989	44114	Fuentespalda	3247	1	0	1	832	0	7598	644	6954	2	140	612
1989	44115	Galve	471	0	0	0	4368	76	85	4	81	1	0	57
1989	44116	Gargallo	96	0	0	0	896	31	6	0	6	0	0	19
1989	44117	Gea de Albarracín	412	16	6	10	2909	622	107	37	70	11	0	104
1989	44118	Ginebrosa (La)	1274	93	7	86	4847	879	2475	428	2047	4	12	1065
1989	44119	Griegos	436	20	0	20	4025	149	6	6	0	0	0	0
1989	44120	Guadalaviar	1056	238	99	139	8096	210	0	0	0	25	0	220
1989	44121	Gúdar	453	107	0	107	3361	178	20	13	7	14	0	12
1989	44122	Híjar	3402	633	35	598	10192	128	7203	317	6886	4	1	404
1989	44123	Hinojosa de Jarque	297	0	0	0	2624	52	69	1	68	0	1	113
1989	44124	Hoz de la Vieja (La)	448	0	0	0	4030	253	37	0	37	3	0	34
1989	44125	Huesa del Común	278	0	0	0	2634	21	17	0	17	3	0	57
1989	44126	Iglesuela del Cid (La)	912	122	0	122	1759	67	2152	125	2027	25	0	127
1989	44127	Jabaloyas	407	0	0	0	3576	136	163	39	124	1	0	31
1989	44128	Jarque de la Val	155	0	0	0	1412	13	29	0	29	0	0	49
1989	44129	Jatiel	52	0	0	0	474	7	5	0	5	1	0	6
1989	44130	Jorcas	234	7	6	1	1899	13	104	58	46	0	0	13
1989	44131	Josa	101	0	0	0	927	24	1	0	1	7	0	2
1989	44132	Lagueruela	128	0	0	0	1130	0	8	8	0	0	0	452
1989	44133	Lanzuela	117	0	0	0	1070	27	0	0	0	0	0	366
1989	44135	Libros	138	13	3	10	1124	4	17	9	8	11	0	30
1989	44136	Lidón	360	32	13	19	3264	11	22	0	22	0	0	31
1989	44137	Linares de Mora	1579	601	2	599	5328	190	1918	222	1696	25	1	44
1989	44138	Loscos	405	50	0	50	3544	134	8	2	6	0	1	61
1989	44141	Lledó	464	0	0	0	154	4	1300	0	1300	2	8	80
1989	44142	Maicas	94	0	0	0	903	15	0	0	0	2	0	1
1989	44143	Manzanera	957	40	3	37	7153	216	838	300	538	13	1	337
1989	44144	Martín del Río	246	0	0	0	2001	37	65	0	65	1	1	670
1989	44145	Mas de las Matas	1627	177	70	107	3154	12	3641	695	2946	21	6	401
1989	44146	Mata de los Olmos (La)	1251	0	0	0	1570	16	2961	1000	1961	1	0	46
1989	44147	Mazaleón	295	0	0	0	2052	58	0	0	0	5	11	85
1989	44148	Mezquita de Jarque	232	0	0	0	2184	31	17	0	17	0	0	40
1989	44149	Mirambel	1411	225	22	203	2012	68	3172	329	2843	14	0	7
1989	44150	Miravete de la Sierra	216	6	0	6	1597	57	85	66	19	7	0	20
1989	44151	Molinos	832	10	4	6	5663	327	1176	355	821	14	0	206
1989	44152	Monforte de Moyuela	425	0	0	0	4071	75	7	0	7	0	0	40
1989	44153	Monreal del Campo	4714	0	0	0	41610	346	3157	437	2720	25	3	316
1989	44154	Monroyo	2374	0	0	0	650	6	6056	465	5591	22	57	202
1989	44155	Montalbán	625	0	0	0	3477	13	519	11	508	8	1	254
1989	44156	Monteagudo del Castillo	290	127	14	113	1635	27	50	33	17	5	0	25
1989	44157	Monterde de Albarracín	260	0	0	0	2384	180	6	0	6	0	0	4
1989	44158	Mora de Rubielos	1180	856	6	850	4153	272	236	194	42	24	0	67
1989	44159	Moscardón	123	0	0	0	929	75	21	8	13	8	0	604
1989	44160	Mosqueruela	1936	304	2	302	14346	399	948	237	711	67	2	369
1989	44161	Muniesa	1349	30	0	30	7155	77	2172	140	2032	3	1	51
1989	44163	Noguera de Albarracín	320	0	0	0	2670	374	23	22	1	7	0	0
1989	44164	Nogueras	91	0	0	0	837	54	0	0	0	0	0	0
1989	44165	Nogueruelas	269	84	0	84	1546	95	95	37	58	16	0	55
1989	44167	Obón	198	0	0	0	1860	85	0	0	0	2	0	8
1989	44168	Odón	927	0	0	0	5347	142	1277	253	1024	0	0	575
1989	44169	Ojos Negros	1049	0	0	0	9071	531	437	90	347	0	1	71
1989	44171	Olba	54	0	0	0	305	69	9	0	9	12	0	33
1989	44172	Oliete	760	171	8	163	5851	74	290	105	185	34	1	112
1989	44173	Olmos (Los)	283	0	0	0	2420	86	46	43	3	0	1	155
1989	44174	Orihuela del Tremedal	514	92	0	92	4291	104	16	1	15	0	0	0
1989	44175	Orrios	598	54	31	23	5277	32	52	10	42	1	0	85
1989	44176	Palomar de Arroyos	202	0	0	0	1810	17	40	0	40	2	0	69
1989	44177	Pancrudo	828	0	0	0	7929	26	44	0	44	0	1	235
1989	44178	Parras de Castellote (Las)	348	0	0	0	1112	51	99	96	3	3	25	269
1989	44179	Peñarroya de Tastavins	9713	0	0	0	1986	91	33653	3101	30552	10	14	805
1989	44180	Peracense	214	0	0	0	1474	337	96	38	58	0	0	16
1989	44181	Peralejos	206	0	0	0	1998	0	8	2	6	1	0	47
1989	44182	Perales del Alfambra	666	0	0	0	6239	35	85	12	73	0	1	93
1989	44183	Pitarque	164	5	0	5	1317	70	29	6	23	19	0	122
1989	44184	Plou	122	0	0	0	1191	3	4	0	4	0	0	9
1989	44185	Pobo (El)	532	229	28	201	2261	28	709	156	553	3	1	112
1989	44187	Portellada (La)	1322	0	0	0	506	7	3800	297	3503	4	12	60
1989	44189	Pozondón	181	0	0	0	1520	23	79	23	56	0	0	264
1989	44190	Pozuel del Campo	301	0	0	0	2678	18	106	28	78	0	0	53
1989	44191	Puebla de Híjar (La)	2530	1441	58	1383	7292	79	4766	281	4485	6	1	27
1989	44192	Puebla de Valverde (La)	1309	103	0	103	11810	250	67	9	58	2	1	93
1989	44193	Puertomingalvo	672	40	0	40	5736	128	52	23	29	44	1	82
1989	44194	Ráfales	136	0	0	0	431	9	38	38	0	5	10	0
1989	44195	Rillo	384	0	0	0	3634	27	39	0	39	0	0	78
1989	44196	Riodeva	232	0	0	0	1683	5	49	0	49	68	0	72
1989	44197	Ródenas	297	20	15	5	2376	63	211	36	175	0	0	2
1989	44198	Royuela	370	40	10	30	2790	174	72	72	0	2	0	160
1989	44199	Rubiales	39	0	0	0	355	0	2	0	2	0	0	175
1989	44200	Rubielos de la Cérida	287	0	0	0	2787	21	13	0	13	0	0	4
1989	44201	Rubielos de Mora	1536	178	0	178	995	106	4719	798	3921	9	0	22
1989	44203	Salcedillo	57	0	0	0	551	11	2	0	2	0	0	5
1989	44204	Saldón	32	0	0	0	244	0	11	0	11	4	0	1
1989	44205	Samper de Calanda	1745	160	110	50	8013	238	2200	210	1990	4	10	315
1989	44206	San Agustín	321	30	0	30	2704	90	22	1	21	25	0	56
1989	44207	San Martín del Río	682	25	15	10	249	1	199	37	162	1	43	29
1989	44208	Santa Cruz de Nogueras	84	0	0	0	721	93	2	0	2	0	0	3
1989	44209	Santa Eulalia	1133	74	42	32	9521	66	488	151	337	5	0	631
1989	44210	Sarrión	876	0	0	0	8560	123	2	0	2	10	0	52
1989	44211	Segura de los Baños	150	0	0	0	1403	36	12	0	12	1	0	12
1989	44212	Seno	136	0	0	0	1230	15	15	0	15	6	0	24
1989	44213	Singra	489	0	0	0	4695	25	24	11	13	7	0	16
1989	44215	Terriente	424	0	0	0	3775	57	59	15	44	21	0	129
1989	44216	Teruel	5731	1862	323	1539	29018	413	3548	356	3192	27	6	523
1989	44217	Toril y Masegoso	198	0	0	0	1856	46	7	0	7	3	0	13
1989	44218	Tormón	4	0	0	0	0	0	4	0	4	3	0	19
1989	44219	Tornos	416	56	0	56	2477	31	389	153	236	0	1	107
1989	44220	Torralba de los Sisones	1169	0	0	0	5503	295	1710	238	1472	1	9	222
1989	44221	Torrecilla de Alcañiz	1699	260	0	260	1227	27	2756	180	2576	2	95	21
1989	44222	Torrecilla del Rebollar	422	0	0	0	4028	16	31	0	31	0	0	339
1989	44223	Torre de Arcas	286	0	0	0	667	0	354	54	300	3	14	0
1989	44224	Torre de las Arcas	150	1	1	0	1170	300	3	0	3	0	0	20
1989	44225	Torre del Compte	100	0	0	0	774	196	0	0	0	3	0	12
1989	44226	Torrelacárcel	895	25	13	12	8101	18	121	48	73	20	1	61
1989	44227	Torre los Negros	201	0	0	0	1914	9	10	5	5	0	0	68
1989	44228	Torremocha de Jiloca	428	0	0	0	3798	24	122	50	72	5	0	13
1989	44229	Torres de Albarracín	432	39	39	0	1025	140	1497	457	1040	5	0	0
1989	44230	Torrevelilla	876	0	0	0	469	219	2290	186	2104	0	29	14
1989	44231	Torrijas	209	0	0	0	1976	37	0	0	0	8	0	7
1989	44232	Torrijo del Campo	2198	41	23	18	6287	10	6282	996	5286	37	1	849
1989	44234	Tramacastiel	130	0	0	0	1182	16	1	1	0	11	0	27
1989	44235	Tramacastilla	277	0	0	0	2372	166	45	45	0	1	0	0
1989	44236	Tronchón	642	349	0	349	1127	96	1186	292	894	17	0	51
1989	44237	Urrea de Gaén	186	0	0	0	1207	6	143	77	66	1	0	863
1989	44238	Utrillas	270	3	0	3	2481	51	22	9	13	0	0	46
1989	44239	Valacloche	57	0	0	0	474	0	9	3	6	9	0	0
1989	44240	Valbona	556	33	22	11	1141	62	1583	179	1404	10	0	61
1989	44241	Valdealgorfa	1074	0	0	0	604	76	1701	200	1501	2	35	8
1989	44243	Valdecuenca	2	0	0	0	8	0	2	0	2	0	0	18
1989	44244	Valdelinares	908	332	0	332	6146	90	10	3	7	25	0	143
1989	44245	Valdeltormo	9	0	0	0	79	0	0	0	0	1	0	11
1989	44246	Valderrobres	3409	562	4	558	4054	395	6968	594	6374	6	110	850
1989	44247	Valjunquera	762	0	0	0	568	16	1101	0	1101	0	53	27
1989	44249	Vallecillo (El)	55	0	0	0	500	0	10	10	0	0	0	0
1989	44250	Veguillas de la Sierra	54	0	0	0	489	18	8	0	8	0	0	9
1989	44251	Villafranca del Campo	1005	0	0	0	9230	92	171	67	104	4	1	88
1989	44252	Villahermosa del Campo	633	0	0	0	828	4	1095	241	854	0	0	21
1989	44256	Villanueva del Rebollar de la Sierra	135	0	0	0	1307	0	15	0	15	0	0	106
1989	44257	Villar del Cobo	1036	64	3	61	9507	140	0	0	0	28	0	200
1989	44258	Villar del Salz	178	0	0	0	1530	76	45	3	42	0	0	22
1989	44260	Villarluengo	1232	420	0	420	5548	270	1240	171	1069	30	1	141
1989	44261	Villarquemado	1866	840	462	378	7373	5	1207	534	673	20	1	576
1989	44262	Villarroya de los Pinares	475	57	0	57	3994	82	42	5	37	5	0	26
1989	44263	Villastar	310	66	31	35	1901	8	134	41	93	16	1	270
1989	44264	Villel	350	140	0	140	2624	1	55	2	53	11	0	172
1989	44265	Vinaceite	2849	596	0	596	4808	37	7316	480	6836	0	31	4
1989	44266	Visiedo	516	36	25	11	4273	44	145	32	113	0	1	88
1989	44267	Vivel del Río Martín	371	0	0	0	2324	6	492	80	412	1	0	24
1989	44268	Zoma (La)	36	0	0	0	338	1	3	0	3	0	0	8
1989	50001	Abanto	212	55	0	55	1246	21	266	80	186	1	0	0
1989	50002	Acered	85	4	0	4	720	9	0	0	0	18	0	0
1989	50003	Agón	189	36	24	12	1514	16	5	5	0	0	0	7
1989	50004	Aguarón	923	0	0	0	680	19	0	0	0	5	122	0
1989	50005	Aguilón	418	0	0	0	2411	152	0	0	0	1	23	0
1989	50006	Ainzón	784	57	5	52	2445	91	1824	90	1734	6	1	116
1989	50007	Aladrén	89	0	0	0	591	274	0	0	0	3	0	0
1989	50008	Alagón	3580	1633	394	1239	3865	8	9742	1820	7922	2	28	2
1989	50009	Alarba	8	0	0	0	0	7	0	0	0	12	0	0
1989	50010	Alberite de San Juan	51	0	0	0	468	6	2	0	2	0	0	121
1989	50011	Albeta	0	0	0	0	0	0	0	0	0	0	0	0
1989	50012	Alborge	4	0	0	0	40	0	0	0	0	0	0	2
1989	50013	Alcalá de Ebro	14	30	0	30	0	0	2	0	2	1	0	14
1989	50014	Alcalá de Moncayo	373	0	0	0	930	38	970	161	809	13	0	0
1989	50015	Alconchel de Ariza	673	37	0	37	4530	55	648	0	648	1	0	13
1989	50016	Aldehuela de Liestos	102	0	0	0	838	3	98	18	80	0	0	11
1989	50017	Alfajarín	1643	755	80	675	9818	154	1214	119	1095	4	0	426
1989	50018	Alfamén	1266	0	0	0	4684	26	0	0	0	2	93	140
1989	50019	Alforque	4246	0	0	0	1047	0	1801	0	1801	0	120	30
1989	50020	Alhama de Aragón	238	286	3	283	1181	2	0	0	0	5	0	2
1989	50021	Almochuel	253	0	0	0	969	2	520	0	520	0	0	1
1989	50022	Almolda (La)	3603	250	0	250	6042	122	8830	611	8219	0	52	25
1989	50023	Almonacid de la Cuba	1951	99	77	22	2479	0	3880	150	3730	0	74	357
1989	50024	Almonacid de la Sierra	441	100	70	30	782	23	1053	135	918	13	0	0
1989	50025	Almunia de Doña Godina (La)	2184	1218	7	1211	3580	12	1241	140	1101	0	138	2000
1989	50026	Alpartir	2757	0	0	0	1151	49	2246	100	2146	1	257	0
1989	50027	Ambel	544	303	3	300	1100	0	1644	492	1152	0	0	0
1989	50028	Anento	122	0	0	0	1042	3	83	26	57	0	0	3
1989	50029	Aniñón	329	30	17	13	1746	18	0	0	0	35	15	0
1989	50030	Añón de Moncayo	783	40	0	40	1707	144	2348	268	2080	25	0	10
1989	50031	Aranda de Moncayo	440	19	10	9	3460	228	245	22	223	13	0	12
1989	50032	Arándiga	774	0	0	0	4152	125	4	0	4	54	44	24
1989	50033	Ardisa	14	0	0	0	49	4	23	10	13	0	0	0
1989	50034	Ariza	988	454	36	418	6555	42	4	0	4	13	0	350
1989	50035	Artieda	461	0	0	0	0	0	2025	200	1825	0	0	2
1989	50036	Asín	1	0	0	0	0	0	0	0	0	1	0	5
1989	50037	Atea	434	0	0	0	1337	148	2	0	2	4	40	2
1989	50038	Ateca	485	21	9	12	1471	5	100	0	100	20	40	0
1989	50039	Azuara	1477	34	22	12	8601	142	890	90	800	1	62	1149
1989	50040	Badules	132	0	0	0	849	22	198	46	152	2	0	10
1989	50041	Bagüés	39	44	0	44	41	0	2	0	2	0	0	4
1989	50042	Balconchán	24	0	0	0	184	17	2	0	2	3	0	34
1989	50043	Bárboles	414	38	4	34	917	0	1275	100	1175	0	0	0
1989	50044	Bardallur	580	494	12	482	2289	33	0	0	0	0	0	0
1989	50045	Belchite	2253	555	24	531	13379	264	1954	248	1706	21	26	514
1989	50046	Belmonte de Gracián	436	4	4	0	1345	4	1146	140	1006	7	0	0
1989	50047	Berdejo	51	0	0	0	493	0	0	0	0	3	0	0
1989	50048	Berrueco	80	0	0	0	764	0	2	0	2	1	0	10
1989	50050	Bijuesca	200	2	0	2	1874	21	8	0	8	7	0	7
1989	50051	Biota	1787	19	13	6	12018	132	1535	452	1083	0	1	140
1989	50052	Bisimbre	94	0	0	0	713	11	0	0	0	0	2	9
1989	50053	Boquiñeni	6232	0	0	0	2166	17	20854	813	20041	2	0	3
1989	50054	Bordalba	135	0	0	0	1302	35	0	0	0	1	0	0
1989	50055	Borja	2357	1547	150	1397	7875	148	1334	216	1118	25	23	735
1989	50056	Botorrita	335	0	0	0	792	27	0	0	0	1	36	0
1989	50057	Brea de Aragón	80	12	12	0	571	1	0	0	0	17	0	0
1989	50058	Bubierca	79	0	0	0	747	0	0	0	0	5	0	0
1989	50059	Bujaraloz	7102	25	0	25	3458	74	10352	860	9492	1	329	368
1989	50060	Bulbuente	840	30	0	30	833	7	283	39	244	12	46	0
1989	50061	Bureta	140	70	0	70	850	12	51	49	2	1	0	0
1989	50062	Burgo de Ebro (El)	2453	0	0	0	3505	395	4557	570	3987	0	90	0
1989	50063	Buste (El)	35	0	0	0	334	5	0	0	0	1	0	0
1989	50064	Cabañas de Ebro	170	133	40	93	0	0	0	0	0	1	12	0
1989	50065	Cabolafuente	241	0	0	0	2378	0	5	0	5	0	0	90
1989	50066	Cadrete	615	0	0	0	817	125	1410	430	980	1	9	0
1989	50067	Calatayud	729	326	5	321	5089	9	72	62	10	37	1	610
1989	50068	Calatorao	2791	198	105	93	7158	0	8852	1180	7672	1	0	0
1989	50069	Calcena	102	0	0	0	853	96	7	6	1	6	0	0
1989	50070	Calmarza	175	0	0	0	1486	129	4	4	0	12	0	79
1989	50071	Campillo de Aragón	275	0	0	0	2594	40	8	0	8	9	0	12
1989	50072	Carenas	117	0	0	0	1059	10	0	0	0	15	0	0
1989	50073	Cariñena	2828	34	4	30	2961	200	4289	720	3569	1	210	916
1989	50074	Caspe	13829	387	51	336	30340	2036	32404	3474	28930	27	305	1620
1989	50075	Castejón de Alarba	17	0	0	0	120	0	6	6	0	2	0	0
1989	50076	Castejón de las Armas	8	0	0	0	0	0	5	0	5	6	0	9
1989	50077	Castejón de Valdejasa	776	0	0	0	2978	141	1522	111	1411	2	5	40
1989	50078	Castiliscar	469	98	60	38	3530	45	89	16	73	1	0	42
1989	50079	Cervera de la Cañada	311	0	0	0	1788	17	277	40	237	10	0	0
1989	50080	Cerveruela	36	0	0	0	353	2	0	0	0	0	0	0
1989	50081	Cetina	852	267	20	247	5485	85	453	0	453	28	0	13
1989	50082	Cimballa	183	26	0	26	1246	24	82	54	28	5	0	2
1989	50083	Cinco Olivas	18	0	0	0	183	0	0	0	0	0	0	0
1989	50084	Clarés de Ribota	141	0	0	0	1353	41	0	0	0	3	0	0
1989	50085	Codo	285	0	0	0	2740	69	4	0	4	2	0	0
1989	50086	Codos	682	9	6	3	4269	165	600	0	600	29	5	0
1989	50087	Contamina	36	24	1	23	242	2	0	0	0	0	0	0
1989	50088	Cosuenda	1543	0	0	0	1052	4	0	0	0	2	103	0
1989	50089	Cuarte de Huerva	107	0	0	0	1070	0	0	0	0	0	0	0
1989	50090	Cubel	393	55	0	55	1692	13	812	160	652	1	0	0
1989	50091	Cuerlas (Las)	117	0	0	0	1027	22	34	9	25	0	0	7
1989	50092	Chiprana	864	0	0	0	8556	26	2	0	2	2	0	29
1989	50093	Chodes	45	0	0	0	360	43	2	0	2	4	0	54
1989	50094	Daroca	887	8	8	0	2141	4	1697	201	1496	17	14	571
1989	50095	Ejea de los Caballeros	25390	829	162	667	67515	778	72944	7074	65870	33	47	2062
1989	50096	Embid de Ariza	178	0	0	0	1300	0	282	80	202	2	0	12
1989	50098	Encinacorba	335	0	0	0	455	249	1120	300	820	4	12	0
1989	50099	Épila	5146	169	81	88	23811	332	8456	955	7501	4	7	31
1989	50100	Erla	2340	0	0	0	2702	68	7535	744	6791	0	0	0
1989	50101	Escatrón	378	0	0	0	3537	100	8	8	0	8	0	34
1989	50102	Fabara	7485	540	0	540	2336	354	11361	2110	9251	0	150	2214
1989	50104	Farlete	921	0	0	0	6773	235	315	211	104	0	15	0
1989	50105	Fayón	39	0	0	0	0	0	1300	0	1300	1	0	20
1989	50106	Fayos (Los)	25	1	0	1	183	1	8	7	1	2	0	8
1989	50107	Figueruelas	1603	39	39	0	1286	0	2159	250	1909	0	60	4
1989	50108	Fombuena	142	137	0	137	419	24	1	0	1	1	0	0
1989	50109	Frago (El)	59	0	0	0	530	47	0	0	0	0	0	3
1989	50110	Frasno (El)	144	0	0	0	599	45	0	0	0	12	10	0
1989	50111	Fréscano	32	0	0	0	305	10	0	0	0	0	0	0
1989	50113	Fuendejalón	810	0	0	0	4267	135	1679	244	1435	0	0	27
1989	50114	Fuendetodos	641	0	0	0	2427	1039	803	200	603	2	9	250
1989	50115	Fuentes de Ebro	2683	399	64	335	9642	131	5375	304	5071	3	3	111
1989	50116	Fuentes de Jiloca	1437	42	5	37	1314	18	2473	311	2162	29	52	1868
1989	50117	Gallocanta	590	0	0	0	1112	10	2066	374	1692	0	0	8
1989	50118	Gallur	1520	348	49	299	5045	75	2852	346	2506	5	1	41
1989	50119	Gelsa	7777	1304	10	1294	3014	8	9486	400	9086	0	256	0
1989	50120	Godojos	790	0	0	0	685	156	0	0	0	9	50	0
1989	50121	Gotor	40	0	0	0	341	12	3	0	3	2	0	5
1989	50122	Grisel	8	0	0	0	0	0	0	0	0	1	0	451
1989	50123	Grisén	57	0	0	0	565	0	0	0	0	0	0	0
1989	50124	Herrera de los Navarros	1806	8	5	3	7378	287	2078	337	1741	10	96	79
1989	50125	Ibdes	274	4	4	0	2125	259	4	4	0	46	0	42
1989	50126	Illueca	40	30	0	30	153	0	1	0	1	14	0	9
1989	50128	Isuerre	198	0	0	0	1221	745	0	0	0	1	0	0
1989	50129	Jaraba	243	0	0	0	2285	29	0	0	0	13	0	44
1989	50130	Jarque de Moncayo	268	0	0	0	1283	25	1043	40	1003	26	0	37
1989	50131	Jaulín	754	0	0	0	2590	50	302	0	302	0	57	0
1989	50132	Joyosa (La)	691	1166	187	979	0	0	0	0	0	0	0	0
1989	50133	Lagata	1641	44	26	18	1975	48	4658	20	4638	6	0	43
1989	50134	Langa del Castillo	862	0	0	0	1543	17	2358	250	2108	1	0	16
1989	50135	Layana	103	0	0	0	1012	17	0	0	0	0	0	0
1989	50136	Lécera	2089	70	40	30	7406	640	3028	138	2890	31	44	0
1989	50137	Leciñena	3775	270	0	270	9825	1762	7348	150	7198	0	58	24
1989	50138	Lechón	123	0	0	0	654	3	170	86	84	0	0	345
1989	50139	Letux	1124	421	163	258	3823	66	647	245	402	12	41	83
1989	50140	Litago	230	0	0	0	1643	46	106	88	18	10	0	36
1989	50141	Lituénigo	108	0	0	0	462	25	91	84	7	15	0	48
1989	50142	Lobera de Onsella	229	0	0	0	2133	136	2	0	2	0	0	4
1989	50143	Longares	252	40	0	40	1763	18	165	23	142	4	0	265
1989	50144	Longás	155	0	0	0	1178	363	0	0	0	0	0	0
1989	50146	Lucena de Jalón	150	96	3	93	27	0	263	60	203	0	0	0
1989	50147	Luceni	786	863	34	829	2704	123	187	124	63	2	0	66
1989	50148	Luesia	1406	138	3	135	2323	848	3365	184	3181	45	0	285
1989	50149	Luesma	105	0	0	0	847	192	3	0	3	0	0	2
1989	50150	Lumpiaque	648	0	0	0	3313	43	674	80	594	0	0	0
1989	50151	Luna	2708	382	0	382	14319	661	7370	157	7213	8	8	732
1989	50152	Maella	1455	0	0	0	4058	364	2423	142	2281	8	19	591
1989	50153	Magallón	1314	0	0	0	3295	46	3400	420	2980	0	0	130
1989	50154	Mainar	927	0	0	0	2084	10	38	31	7	0	50	1
1989	50155	Malanquilla	73	0	0	0	706	23	0	0	0	0	0	0
1989	50156	Maleján	0	0	0	0	0	0	0	0	0	0	0	0
1989	50157	Malón	1248	0	0	0	639	7	2369	320	2049	0	35	32
1989	50159	Maluenda	789	74	7	67	571	263	2	0	2	35	45	0
1989	50160	Mallén	1252	497	104	393	2873	102	3896	255	3641	0	15	1
1989	50161	Manchones	114	27	20	7	800	8	12	8	4	7	0	11
1989	50162	Mara	190	0	0	0	1154	11	304	38	266	3	0	8
1989	50163	María de Huerva	2973	0	0	0	3953	77	6241	300	5941	1	87	10
1989	50164	Mediana de Aragón	1250	263	39	224	9147	45	352	20	332	5	2	200
1989	50165	Mequinenza	5204	33	16	17	4246	659	10883	702	10181	1	227	817
1989	50166	Mesones de Isuela	990	1	1	0	6380	215	386	177	209	23	30	453
1989	50167	Mezalocha	587	4	4	0	2695	63	240	65	175	4	37	12
1989	50168	Mianos	42	0	0	0	282	7	21	20	1	0	0	3
1989	50169	Miedes de Aragón	525	26	12	14	2544	35	367	86	281	11	22	449
1989	50170	Monegrillo	1501	0	0	0	14457	485	14	13	1	0	0	0
1989	50171	Moneva	353	0	0	0	3415	63	0	0	0	6	0	0
1989	50172	Monreal de Ariza	874	396	24	372	6235	33	185	57	128	5	0	426
1989	50173	Monterde	194	20	0	20	1641	16	10	10	0	6	0	0
1989	50174	Montón	33	0	0	0	262	0	10	8	2	3	0	7
1989	50175	Morata de Jalón	792	25	22	3	1823	71	1343	106	1237	31	15	19
1989	50176	Morata de Jiloca	137	26	13	13	1123	8	8	0	8	3	0	4
1989	50177	Morés	230	0	0	0	1472	11	2	0	2	13	10	54
1989	50178	Moros	337	0	0	0	2488	8	240	40	200	56	0	14
1989	50179	Moyuela	1176	261	130	131	4313	58	1923	187	1736	1	8	69
1989	50180	Mozota	97	0	0	0	957	16	0	0	0	0	0	0
1989	50181	Muel	1533	57	0	57	4754	62	900	400	500	3	57	2
1989	50182	Muela (La)	1314	59	33	26	7507	29	2015	215	1800	0	0	1774
1989	50183	Munébrega	138	77	18	59	771	13	14	0	14	15	0	5
1989	50184	Murero	248	0	0	0	1084	116	822	200	622	6	0	14
1989	50185	Murillo de Gállego	146	0	0	0	1129	195	30	26	4	0	0	5
1989	50186	Navardún	185	0	0	0	1699	135	0	0	0	0	0	0
1989	50187	Nigüella	155	1	1	0	1241	46	89	36	53	6	0	62
1989	50188	Nombrevilla	36	0	0	0	250	1	22	0	22	0	0	0
1989	50189	Nonaspe	2415	0	0	0	1850	466	6895	575	6320	5	48	1069
1989	50190	Novallas	723	34	6	28	753	0	700	51	649	1	52	5
1989	50191	Novillas	1431	315	7	308	2826	33	2916	143	2773	2	9	0
1989	50192	Nuévalos	1073	0	0	0	1582	29	0	0	0	3	130	0
1989	50193	Nuez de Ebro	114	0	0	0	1137	0	0	0	0	0	0	0
1989	50194	Olvés	76	0	0	0	634	2	4	0	4	17	0	2
1989	50195	Orcajo	60	0	0	0	580	20	0	0	0	0	0	0
1989	50196	Orera	123	0	0	0	954	195	0	0	0	10	0	2
1989	50197	Orés	173	0	0	0	1698	19	0	0	0	1	0	0
1989	50198	Oseja	1	0	0	0	0	0	0	0	0	1	0	0
1989	50199	Osera de Ebro	193	100	0	100	0	0	1	1	0	0	15	0
1989	50200	Paniza	198	0	0	0	1213	76	0	0	0	4	8	701
1989	50201	Paracuellos de Jiloca	26	0	0	0	242	0	0	0	0	1	0	60
1989	50202	Paracuellos de la Ribera	74	0	0	0	549	11	0	0	0	30	0	3
1989	50203	Pastriz	389	0	0	0	2169	37	9	0	9	3	23	2
1989	50204	Pedrola	1978	519	116	403	10553	88	759	122	637	3	60	45
1989	50205	Pedrosas (Las)	84	0	0	0	823	21	0	0	0	0	0	0
1989	50206	Perdiguera	1567	0	0	0	4347	132	2711	30	2681	0	46	73
1989	50207	Piedratajada	592	185	0	185	958	33	974	67	907	0	0	2
1989	50208	Pina de Ebro	4641	3098	103	2995	15075	15	4513	193	4320	0	20	50
1989	50209	Pinseque	1477	2234	253	1981	2840	334	12	1	11	2	0	62
1989	50210	Pintanos (Los)	481	77	0	77	4029	149	5	0	5	0	0	8
1989	50211	Plasencia de Jalón	1236	0	0	0	4505	22	1158	30	1128	0	66	83
1989	50212	Pleitas	116	106	24	82	520	7	0	0	0	1	0	5
1989	50213	Plenas	490	0	0	0	2242	0	618	15	603	9	11	53
1989	50214	Pomer	43	0	0	0	405	17	0	0	0	0	0	0
1989	50215	Pozuel de Ariza	70	0	0	0	675	3	18	0	18	0	0	2
1989	50216	Pozuelo de Aragón	820	0	0	0	5715	58	1289	382	907	0	0	15
1989	50217	Pradilla de Ebro	612	309	4	305	3459	52	325	110	215	0	10	18
1989	50218	Puebla de Albortón	315	0	0	0	2770	300	0	0	0	6	0	10
1989	50219	Puebla de Alfindén (La)	724	296	39	257	1778	78	4	0	4	1	55	6
1989	50220	Puendeluna	63	0	0	0	0	0	203	0	203	0	0	1
1989	50221	Purujosa	165	0	0	0	1628	17	0	0	0	1	0	0
1989	50222	Quinto	5375	1942	354	1588	10845	146	12702	1254	11448	0	0	150
1989	50223	Remolinos	1137	122	30	92	1503	14	3062	33	3029	1	0	10
1989	50224	Retascón	124	0	0	0	1226	4	0	0	0	0	0	7
1989	50225	Ricla	1468	147	45	102	7189	78	1364	200	1164	8	23	356
1989	50227	Romanos	783	0	0	0	2282	31	2438	307	2131	0	0	16
1989	50228	Rueda de Jalón	669	16	3	13	5609	0	334	10	324	0	0	7
1989	50229	Ruesca	36	0	0	0	331	0	2	0	2	3	0	0
1989	50230	Sádaba	1993	6	6	0	7422	41	3328	249	3079	1	35	279
1989	50231	Salillas de Jalón	280	49	0	49	2265	0	135	27	108	4	0	10
1989	50232	Salvatierra de Esca	580	204	0	204	2220	276	550	50	500	19	0	0
1989	50233	Samper del Salz	89	40	20	20	534	12	4	0	4	1	0	15
1989	50234	San Martín de la Virgen de Moncayo	127	3	2	1	614	9	167	114	53	3	0	6
1989	50235	San Mateo de Gállego	7073	1176	38	1138	5898	290	14179	1430	12749	8	337	27
1989	50236	Santa Cruz de Grío	126	0	0	0	1066	21	0	0	0	28	0	0
1989	50237	Santa Cruz de Moncayo	107	0	0	0	0	0	1	0	1	3	15	0
1989	50238	Santa Eulalia de Gállego	151	0	0	0	1189	87	753	0	753	0	0	16
1989	50239	Santed	62	0	0	0	582	18	6	0	6	0	0	3
1989	50240	Sástago	4193	166	5	161	12439	491	1670	1	1669	0	205	146
1989	50241	Saviñán	203	45	25	20	894	0	264	36	228	3	1	140
1989	50242	Sediles	28	0	0	0	202	0	0	0	0	11	0	0
1989	50243	Sestrica	348	25	0	25	1410	35	0	0	0	29	25	16
1989	50244	Sierra de Luna	271	6	3	3	2561	65	0	0	0	0	0	0
1989	50245	Sigüés	173	0	0	0	1563	152	0	0	0	0	0	0
1989	50246	Sisamón	138	0	0	0	1309	49	1	0	1	1	0	0
1989	50247	Sobradiel	856	325	80	245	4225	4	610	2	608	2	0	16
1989	50248	Sos del Rey Católico	916	131	52	79	7476	255	71	65	6	3	0	20
1989	50249	Tabuenca	1128	8	0	8	7739	686	1448	433	1015	8	0	16
1989	50250	Talamantes	65	0	0	0	400	0	940	0	940	0	0	0
1989	50251	Tarazona	6686	880	53	827	14115	676	8931	1835	7096	37	218	184
1989	50252	Tauste	18608	3916	1876	2040	38163	715	47625	5899	41726	12	3	235
1989	50253	Terrer	173	0	0	0	1713	0	0	0	0	3	0	1
1989	50254	Tierga	410	9	1	8	3056	171	352	107	245	16	0	44
1989	50255	Tobed	623	0	0	0	715	21	700	0	700	6	48	0
1989	50256	Torralba de los Frailes	325	0	0	0	3136	28	18	0	18	0	0	5
1989	50257	Torralba de Ribota	173	6	6	0	1484	8	0	0	0	29	0	0
1989	50258	Torralbilla	165	0	0	0	1608	23	5	0	5	0	0	2
1989	50259	Torrehermosa	361	43	0	43	3287	58	20	0	20	2	0	13
1989	50260	Torrelapaja	68	0	0	0	657	20	0	0	0	0	0	0
1989	50261	Torrellas	142	100	0	100	155	0	4	4	0	0	12	3
1989	50262	Torres de Berrellén	1222	720	72	648	5665	229	1644	90	1554	1	0	100
1989	50263	Torrijo de la Cañada	976	32	6	26	4339	74	1704	250	1454	72	1	58
1989	50264	Tosos	266	0	0	0	1286	27	0	0	0	3	19	0
1989	50265	Trasmoz	244	0	0	0	2087	40	52	47	5	4	0	36
1989	50266	Trasobares	446	0	0	0	3129	141	297	183	114	29	0	12
1989	50267	Uncastillo	981	44	24	20	8149	932	1100	0	1100	1	1	67
1989	50268	Undués de Lerda	125	0	0	0	1230	12	0	0	0	0	0	0
1989	50269	Urrea de Jalón	208	42	9	33	600	0	354	200	154	0	0	4
1989	50270	Urriés	59	0	0	0	545	28	0	0	0	2	0	0
1989	50271	Used	1256	0	0	0	3731	82	3822	540	3282	0	0	54
1989	50272	Utebo	784	667	111	556	2934	0	35	6	29	0	3	361
1989	50273	Valdehorna	53	0	0	0	468	0	4	0	4	5	0	24
1989	50274	Val de San Martín	153	0	0	0	1459	40	0	0	0	1	0	22
1989	50275	Valmadrid	217	0	0	0	405	14	7	0	7	1	24	18
1989	50276	Valpalmas	578	0	0	0	3419	132	15	0	15	0	30	21
1989	50277	Valtorres	30	0	0	0	230	0	3	0	3	8	0	0
1989	50278	Velilla de Ebro	813	0	0	0	3125	0	1200	0	1200	0	10	0
1989	50279	Velilla de Jiloca	80	0	0	0	738	28	0	0	0	5	0	10
1989	50280	Vera de Moncayo	784	8	4	4	2213	75	1145	514	631	6	13	0
1989	50281	Vierlas	215	0	0	0	170	2	6	0	6	0	14	3
1989	50282	Vilueña (La)	3	0	0	0	0	1	0	0	0	3	0	0
1989	50283	Villadoz	157	0	0	0	1535	14	5	0	5	0	0	6
1989	50284	Villafeliche	95	0	0	0	809	21	4	0	4	10	0	160
1989	50285	Villafranca de Ebro	635	8	8	0	855	25	1662	160	1502	0	0	5
1989	50286	Villalba de Perejil	268	0	0	0	358	0	550	60	490	1	14	431
1989	50287	Villalengua	99	0	0	0	903	14	0	0	0	11	0	5
1989	50288	Villanueva de Gállego	4189	410	0	410	5884	50	9345	908	8437	0	95	11
1989	50289	Villanueva de Jiloca	17	0	0	0	0	0	91	20	71	0	0	31
1989	50290	Villanueva de Huerva	541	0	0	0	2926	221	2	0	2	3	30	554
1989	50291	Villar de los Navarros	675	0	0	0	4033	96	712	175	537	1	22	6
1989	50292	Villarreal de Huerva	5914	0	0	0	355	10	3026	10	3016	0	370	31
1989	50293	Villarroya de la Sierra	866	133	80	53	4481	53	866	106	760	41	0	22
1989	50294	Villarroya del Campo	147	0	0	0	1408	16	8	0	8	0	0	20
1989	50295	Vistabella	6	0	0	0	60	0	0	0	0	0	0	0
1989	50296	Zaida (La)	256	0	0	0	2520	25	0	0	0	0	0	100
1989	50297	Zaragoza	15798	6498	2281	4217	39279	516	14021	539	13482	16	256	798
1989	50298	Zuera	5744	2476	544	1932	19144	347	6736	459	6277	10	69	1014
1989	50901	Biel	143	0	0	0	1043	205	4	2	2	4	0	804
1999	22001	Abiego	2194	0	0	0	3488	80	5493	569	4924	5	0,202	81
1999	22002	Abizanda	976	119	0	119	2514	20	1416	29	1387	0	0,36	38
1999	22003	Adahuesca	205	0	0	0	2032	0	0	0	0	0	0,137	11
1999	22004	Agüero	187	45	0	45	1266	145	2	0	2	10	0,072	1
1999	22006	Aísa	459	174	0	174	3119	81	10	0	10	0	0,19	56
1999	22007	Albalate de Cinca	8331	4610	269	4341	2103	281	6484	113	6371	0	195,02	0
1999	22008	Albalatillo	1957	1089	0	1089	0	0	5903	486	5417	0	17,047	0
1999	22009	Albelda	17403	3791	181	3610	7488	159	37080	1147	35933	15	189,082	786
1999	22011	Albero Alto	1653	0	0	0	0	0	4460	0	4460	0	45	0
1999	22012	Albero Bajo	1431	295	0	295	680	0	3900	0	3900	0	0	0
1999	22013	Alberuela de Tubo	2315	1087	0	1087	4020	15	5005	102	4903	0	0,601	10
1999	22014	Alcalá de Gurrea	147	120	0	120	892	36	7	0	7	1	0,145	0
1999	22015	Alcalá del Obispo	10129	932	0	932	3383	18	29811	2310	27501	0	75,016	0
1999	22016	Alcampell	9148	1706	6	1700	5240	139	27729	1637	26092	12	4,075	17
1999	22017	Alcolea de Cinca	9651	1851	31	1820	3947	7	26723	204	26519	0	156,157	1268
1999	22018	Alcubierre	12522	248	36	212	4433	68	41946	1218	40728	0	0,025	500
1999	22019	Alerre	32	0	0	0	315	0	0	0	0	0	0	0
1999	22020	Alfántega	2888	180	0	180	327	5	12505	350	12155	0	0,096	0
1999	22021	Almudévar	5189	2498	220	2278	16117	411	7715	290	7425	5	12,542	705
1999	22022	Almunia de San Juan	6284	2099	0	2099	4583	61	12376	615	11761	0	84,345	3
1999	22023	Almuniente	10622	148	38	110	7730	33	35362	2710	32652	0	17,03	0
1999	22024	Alquézar	376	0	0	0	2974	58	329	105	224	0	0,192	219
1999	22025	Altorricón	22959	11651	169	11482	3808	48	61418	3788	57630	0	122,12	12
1999	22027	Angüés	1333	711	0	711	650	36	3579	590	2989	0	17,589	2
1999	22028	Ansó	1278	877	0	877	6102	318	3	0	3	8	0,065	0
1999	22029	Antillón	857	0	0	0	1036	31	2500	0	2500	0	0	0
1999	22032	Aragüés del Puerto	194	262	0	262	22	48	10	0	10	1	0,073	6
1999	22035	Arén	4484	893	60	833	19409	719	8030	641	7389	2	0,668	130
1999	22036	Argavieso	619	0	0	0	1374	22	1599	0	1599	0	0,01	0
1999	22037	Arguis	363	116	0	116	912	14	680	80	600	58	0,12	4
1999	22039	Ayerbe	391	92	15	77	1747	156	657	184	473	19	0,54	54
1999	22040	Azanuy-Alins	1568	430	0	430	1247	56	3385	0	3385	0	34,028	600
1999	22041	Azara	595	1	1	0	23	0	2377	577	1800	0	0,254	17
1999	22042	Azlor	324	183	26	157	1405	46	492	132	360	1	0,195	15
1999	22043	Baells	1587	120	0	120	417	4	4190	0	4190	0	30,23	4
1999	22044	Bailo	2014	822	0	822	13615	247	61	31	30	32	0,225	21
1999	22045	Baldellou	693	0	0	0	934	2	2120	150	1970	1	0,172	603
1999	22046	Ballobar	2912	1052	19	1033	14998	204	4332	160	4172	0	25,1	2820
1999	22047	Banastás	5	0	0	0	49	0	0	0	0	0	0	0
1999	22048	Barbastro	12656	2399	63	2336	7217	209	36292	3246	33046	24	2,001	1346
1999	22049	Barbués	1376	28	22	6	558	10	4360	20	4340	1	0,238	0
1999	22050	Barbuñales	4	0	0	0	0	0	0	0	0	0	0	200
1999	22051	Bárcabo	1270	988	1	987	2592	0	2716	293	2423	0	0,054	37
1999	22052	Belver de Cinca	16472	5935	170	5765	11768	188	42624	6	42618	1	0,03	105
1999	22053	Benabarre	12124	1639	0	1639	8401	638	39166	5046	34120	0	114,602	826
1999	22054	Benasque	917	644	0	644	4382	97	0	0	0	55	0,264	21
1999	22055	Berbegal	2066	762	45	717	2640	20	3712	180	3532	3	31,231	0
1999	22057	Bielsa	636	602	2	600	1539	480	0	0	0	13	0,163	23
1999	22058	Bierge	830	46	0	46	3953	186	1128	115	1013	3	16,332	69
1999	22059	Biescas	1227	1097	0	1097	3938	123	10	0	10	21	0,234	37
1999	22060	Binaced	11151	4399	400	3999	4289	9	27356	813	26543	14	133,505	730
1999	22061	Binéfar	11219	9325	54	9271	1337	600	23864	1829	22035	0	0,049	970
1999	22062	Bisaurri	3749	1844	64	1780	5396	169	6500	0	6500	30	0,436	247
1999	22063	Biscarrués	3150	0	0	0	3259	111	8008	51	7957	0	63,763	312
1999	22064	Blecua y Torres	2284	540	0	540	1691	26	6865	580	6285	0	0,094	0
1999	22066	Boltaña	1572	1351	22	1329	4159	964	550	64	486	31	0,305	77
1999	22067	Bonansa	1033	791	0	791	4191	146	3	0	3	1	0,127	422
1999	22068	Borau	343	198	10	188	1951	79	2	2	0	5	0,081	7
1999	22069	Broto	1876	2189	20	2169	3216	398	6	0	6	21	0,469	69
1999	22072	Caldearenas	797	167	0	167	4135	88	1219	479	740	0	0,077	19
1999	22074	Campo	1428	190	80	110	2800	80	2601	300	2301	0	45	0
1999	22075	Camporrells	3150	75	0	75	796	9	9923	117	9806	0	0,152	733
1999	22076	Canal de Berdún	925	241	0	241	7196	278	42	6	36	4	1,121	52
1999	22077	Candasnos	5145	100	0	100	4551	73	13772	700	13072	2	35,076	230
1999	22078	Canfranc	19	24	5	19	0	0	0	0	0	0	0,035	0
1999	22079	Capdesaso	545	333	48	285	237	0	1070	0	1070	14	0	0
1999	22080	Capella	3030	350	0	350	1465	21	9904	1364	8540	1	40,134	40
1999	22081	Casbas de Huesca	2352	305	80	225	3523	105	6084	121	5963	3	0,241	2
1999	22082	Castejón del Puente	1262	90	0	90	4311	166	3998	640	3358	0	0,009	0
1999	22083	Castejón de Monegros	4031	202	0	202	9395	216	11083	1830	9253	23	38,166	132
1999	22084	Castejón de Sos	645	515	0	515	2905	71	0	0	0	0	0,311	22
1999	22085	Castelflorite	744	96	60	36	2443	259	1300	0	1300	0	0,109	0
1999	22086	Castiello de Jaca	559	8	8	0	1198	129	124	33	91	0	26,861	85
1999	22087	Castigaleu	591	600	0	600	1896	29	908	165	743	0	0,006	4
1999	22088	Castillazuelo	1081	722	0	722	0	0	1840	30	1810	1	0,045	2
1999	22089	Castillonroy	3636	350	0	350	757	19	11916	381	11535	0	0,028	465
1999	22090	Colungo	614	81	0	81	1702	35	1330	306	1024	0	0	400
1999	22094	Chalamera	2131	814	42	772	1925	0	4650	0	4650	0	20	0
1999	22095	Chía	547	568	0	568	1582	46	0	0	0	11	0,131	224
1999	22096	Chimillas	0	0	0	0	0	0	0	0	0	0	0,004	0
1999	22099	Esplús	9658	6119	0	6119	2710	29	17965	864	17101	3	156,157	150
1999	22102	Estada	2065	0	0	0	197	2	5091	223	4868	1	90,341	938
1999	22103	Estadilla	7767	4338	54	4284	4323	134	20315	1092	19223	4	1,019	762
1999	22105	Estopiñán del Castillo	6167	172	0	172	2415	143	27972	3498	24474	1	1,543	4
1999	22106	Fago	131	172	0	172	0	36	0	0	0	10	0	0
1999	22107	Fanlo	220	233	0	233	233	347	0	0	0	1	0,058	7
1999	22109	Fiscal	1723	1796	6	1790	2275	231	832	17	815	3	0,593	71
1999	22110	Fonz	10861	2962	16	2946	6135	50	28044	876	27168	0	36,37	202
1999	22111	Foradada del Toscar	5260	1237	184	1053	9190	246	11674	1236	10438	0	77,788	104
1999	22112	Fraga	60042	6481	212	6269	15621	1174	108438	6790	101648	55	1337,521	1462
1999	22113	Fueva (La)	5844	2118	122	1996	12332	249	17431	2215	15216	66	2,347	288
1999	22114	Gistaín	703	399	0	399	3786	329	4	0	4	9	0,247	79
1999	22115	Grado (El)	2085	116	0	116	2108	35	5156	653	4503	2	0,664	38
1999	22116	Grañén	13879	5415	316	5099	15309	158	33444	1253	32191	2	60,793	846
1999	22117	Graus	7568	1716	67	1649	14374	402	14199	2189	12010	1	189,467	655
1999	22119	Gurrea de Gállego	3092	1235	20	1215	15860	124	2531	307	2224	16	11,166	45
1999	22122	Hoz de Jaca	126	102	0	102	410	0	0	0	0	0	0	574
1999	22124	Huerto	2288	233	65	168	3089	35	5756	3	5753	3	14,275	12
1999	22125	Huesca	12141	3096	27	3069	12383	563	45983	8194	37789	20	61,789	513
1999	22126	Ibieca	1580	0	0	0	1903	39	2278	0	2278	0	50,2	0
1999	22127	Igriés	5018	100	0	100	404	16	6292	50	6242	20	100,032	0
1999	22128	Ilche	2655	1149	0	1149	7098	48	5924	700	5224	0	0,259	8
1999	22129	Isábena	2402	507	0	507	11657	802	2757	444	2313	0	32,589	80
1999	22130	Jaca	6556	967	20	947	35177	601	5953	626	5327	101	44,509	2033
1999	22131	Jasa	274	374	0	374	39	75	0	0	0	1	0,068	16
1999	22133	Labuerda	183	77	46	31	1168	11	0	0	0	0	0,015	5
1999	22135	Laluenga	1429	90	0	90	2481	43	4026	237	3789	2	0,444	17
1999	22136	Lalueza	11240	2003	214	1789	12916	150	29177	493	28684	3	30,15	752
1999	22137	Lanaja	8035	1509	80	1429	11261	219	23900	585	23315	1	0,585	7
1999	22139	Laperdiguera	1659	347	0	347	0	0	5707	242	5465	0	0,032	0
1999	22141	Lascellas-Ponzano	1576	264	0	264	532	1	6072	125	5947	0	0,328	15
1999	22142	Lascuarre	968	196	0	196	338	38	2978	535	2443	0	0	90
1999	22143	Laspaúles	1718	1469	13	1456	7476	219	4	0	4	31	0,358	59
1999	22144	Laspuña	467	245	0	245	2132	546	16	0	16	18	0,203	43
1999	22149	Loarre	2657	127	0	127	2114	132	5118	466	4652	2	127,427	32
1999	22150	Loporzano	1067	0	0	0	6077	114	632	30	602	8	35,091	6
1999	22151	Loscorrales	152	0	0	0	1315	45	90	24	66	0	0,054	5
1999	22155	Monesma y Cajigar	1400	0	0	0	6107	50	1778	453	1325	0	20,011	4
1999	22156	Monflorite-Lascasas	1581	70	0	70	1403	0	1701	305	1396	3	84,126	2
1999	22157	Montanuy	4503	3310	8	3302	19149	402	1123	5	1118	55	0,822	153
1999	22158	Monzón	17655	13081	544	12537	11280	169	34955	1848	33107	30	156,6	1189
1999	22160	Naval	1800	116	3	113	2904	51	1191	241	950	16	164,236	401
1999	22162	Novales	1535	0	0	0	0	0	5346	95	5251	0	0	0
1999	22163	Nueno	1015	0	0	0	3048	344	2488	270	2218	17	0,145	12
1999	22164	Olvena	1246	242	0	242	915	6	4017	176	3841	0	0,057	253
1999	22165	Ontiñena	3393	3122	21	3101	8139	126	4471	406	4065	2	10,278	270
1999	22167	Osso de Cinca	15234	6553	240	6313	1250	50	8699	63	8636	28	374,54	0
1999	22168	Palo	182	160	0	160	61	19	1734	120	1614	0	0,063	5
1999	22170	Panticosa	637	895	0	895	1238	305	0	0	0	2	0,024	201
1999	22172	Peñalba	3430	553	0	553	7203	110	6430	230	6200	1	94,18	0
1999	22173	Peñas de Riglos (Las)	826	352	0	352	3573	318	769	0	769	3	0,428	18
1999	22174	Peralta de Alcofea	6684	393	0	393	5462	184	17360	52	17308	0	36,01	300
1999	22175	Peralta de Calasanz	1275	871	0	871	3518	7	1893	185	1708	2	0,348	1247
1999	22176	Peraltilla	871	57	0	57	267	11	2939	243	2696	2	0,144	7
1999	22177	Perarrúa	880	0	0	0	548	42	2490	323	2167	0	14,423	43
1999	22178	Pertusa	1050	361	0	361	1260	15	4000	335	3665	0	0,012	0
1999	22181	Piracés	1165	90	0	90	0	0	3577	463	3114	0	20,01	270
1999	22182	Plan	1018	798	0	798	3655	580	5	0	5	33	0,35	78
1999	22184	Poleñino	5608	283	0	283	2781	41	14819	751	14068	0	20,063	17
1999	22186	Pozán de Vero	564	0	0	0	0	0	1571	20	1551	0	0,153	5
1999	22187	Puebla de Castro (La)	885	0	0	0	912	10	532	0	532	12	88,715	33
1999	22188	Puente de Montañana	310	0	0	0	3040	56	0	0	0	0	0	0
1999	22189	Puértolas	1639	789	3	786	2923	834	2462	6	2456	51	0,236	20
1999	22190	Pueyo de Araguás (El)	901	524	0	524	5834	363	132	57	75	3	0,208	68
1999	22193	Pueyo de Santa Cruz	1398	475	65	410	1515	0	3604	500	3104	0	0	0
1999	22195	Quicena	450	22	0	22	2415	130	610	0	610	0	0	0
1999	22197	Robres	18778	876	0	876	13540	92	59136	2944	56192	1	90,282	15
1999	22199	Sabiñánigo	4248	1859	0	1859	19634	664	3798	149	3649	69	2,505	97
1999	22200	Sahún	642	523	8	515	2665	62	0	0	0	0	0,486	50
1999	22201	Salas Altas	223	0	0	0	0	0	525	5	520	0	8,822	30
1999	22202	Salas Bajas	3	0	0	0	25	0	0	0	0	0	0,012	2
1999	22203	Salillas	1463	0	0	0	0	0	5917	1123	4794	0	0,008	640
1999	22204	Sallent de Gállego	1038	1189	4	1185	633	294	7	0	7	110	0,374	324
1999	22205	San Esteban de Litera	9683	5252	20	5232	3265	13	16036	1575	14461	25	100,243	147
1999	22206	Sangarrén	3370	230	100	130	1922	0	6860	460	6400	0	120,02	0
1999	22207	San Juan de Plan	700	547	0	547	2870	240	0	0	0	16	0,314	75
1999	22208	Santa Cilia	241	0	0	0	2217	50	53	14	39	0	0,178	23
1999	22209	Santa Cruz de la Serós	423	0	0	0	4061	26	31	6	25	0	0,221	229
1999	22212	Santaliestra y San Quílez	493	0	0	0	0	0	1040	101	939	0	27,077	17
1999	22213	Sariñena	13745	3182	218	2964	20071	485	29585	350	29235	3	194,563	244
1999	22214	Secastilla	1428	118	0	118	2495	13	4031	165	3866	0	0,167	62
1999	22215	Seira	250	133	0	133	1116	362	0	0	0	7	0,139	26
1999	22217	Sena	1902	797	137	660	7175	129	2000	750	1250	2	0	110
1999	22218	Senés de Alcubierre	2751	423	0	423	300	0	8526	1445	7081	0	0,094	0
1999	22220	Sesa	949	120	0	120	1592	24	2311	382	1929	0	60	0
1999	22221	Sesué	229	322	5	317	28	0	0	0	0	2	0,135	23
1999	22222	Siétamo	3214	0	0	0	4513	102	9364	198	9166	27	0	0
1999	22223	Sopeira	721	457	0	457	1901	216	1485	329	1156	0	0,159	58
1999	22225	Tamarite de Litera	42417	16175	1640	14535	10798	308	108127	4444	103683	100	71,976	410
1999	22226	Tardienta	1946	1303	32	1271	10753	283	1336	360	976	10	1,036	20
1999	22227	Tella-Sin	242	164	0	164	792	311	0	0	0	14	0,098	29
1999	22228	Tierz	687	0	0	0	335	0	2178	0	2178	0	0,018	0
1999	22229	Tolva	2325	45	0	45	4097	90	5882	1612	4270	0	0,041	13
1999	22230	Torla-Ordesa	999	1153	52	1101	1616	104	0	0	0	0	0,2	35
1999	22232	Torralba de Aragón	983	354	100	254	5504	67	626	0	626	0	5,098	0
1999	22233	Torre la Ribera	578	222	0	222	3983	118	12	9	3	11	0,298	108
1999	22234	Torrente de Cinca	3301	0	0	0	900	0	7350	400	6950	0	80,304	575
1999	22235	Torres de Alcanadre	1351	0	0	0	0	0	5184	495	4689	0	0	0
1999	22236	Torres de Barbués	1692	231	0	231	3234	0	3750	650	3100	0	0	0
1999	22239	Tramaced	3505	1006	0	1006	1468	4	7503	3	7500	0	80,113	0
1999	22242	Valfarta	860	0	0	0	1800	12	2260	0	2260	1	0	0
1999	22243	Valle de Bardají	647	616	285	331	2027	120	6	6	0	1	0,004	1
1999	22244	Valle de Lierp	393	456	42	414	1677	110	2	0	2	0	0	0
1999	22245	Velilla de Cinca	466	0	0	0	755	0	1300	0	1300	0	0	0
1999	22246	Beranuy	988	0	0	0	3657	295	2483	807	1676	3	0,469	156
1999	22247	Viacamp y Litera	1171	701	0	701	3126	49	2118	198	1920	0	0,006	0
1999	22248	Vicién	667	850	0	850	3175	0	45	14	31	0	0,09	6
1999	22249	Villanova	222	259	0	259	402	12	0	0	0	6	0,065	10
1999	22250	Villanúa	112	56	0	56	417	52	32	21	11	0	0,361	50
1999	22251	Villanueva de Sigena	4236	1584	0	1584	13868	165	7000	215	6785	0	0	0
1999	22252	Yebra de Basa	343	302	0	302	1353	0	6	0	6	0	0,175	7
1999	22253	Yésero	172	247	14	233	0	0	2	0	2	0	0	130
1999	22254	Zaidín	27369	2555	0	2555	6308	100	72767	1516	71251	1	601,032	0
1999	22901	Valle de Hecho	2631	1967	0	1967	11452	680	59	0	59	10	0,345	68
1999	22902	Puente la Reina de Jaca	1890	0	0	0	14318	145	2104	563	1541	1	0,201	30
1999	22903	San Miguel del Cinca	9168	1299	0	1299	4274	87	21307	1486	19821	0	92,039	430
1999	22904	Sotonera (La)	2626	234	1	233	14990	120	3552	457	3095	2	0,245	18
1999	22905	Lupiñén-Ortilla	1084	21	0	21	6852	18	8	0	8	0	51,961	870
1999	22906	Santa María de Dulcis	215	46	32	14	1467	10	59	19	40	0	0,418	122
1999	22907	Aínsa-Sobrarbe	3471	1459	21	1438	15013	387	5494	711	4783	48	9,927	171
1999	22908	Hoz y Costeán	618	499	0	499	2460	4	944	252	692	0	0,088	500
1999	22909	Vencillón	9061	5689	0	5689	6544	35	22334	1108	21226	3	0,657	20
1999	44001	Ababuj	288	105	0	105	2296	27	49	11	38	0	0,024	4
1999	44002	Abejuela	265	0	0	0	2629	15	0	0	0	0	0,02	4
1999	44003	Aguatón	122	0	0	0	1195	0	4	0	4	0	0,059	11
1999	44004	Aguaviva	4978	305	0	305	2563	15	17583	2255	15328	0	0,417	1100
1999	44005	Aguilar del Alfambra	243	2	0	2	2227	3	64	15	49	0	0	500
1999	44006	Alacón	3798	0	0	0	5290	99	11808	1772	10036	0	0,091	0
1999	44007	Alba	1916	0	0	0	14065	19	1637	101	1536	13	0,436	38
1999	44008	Albalate del Arzobispo	1218	0	0	0	3655	95	1000	0	1000	0	52,06	518
1999	44009	Albarracín	1205	34	8	26	10964	666	16	3	13	3	0,61	39
1999	44010	Albentosa	704	146	0	146	3791	37	785	115	670	1	0,177	22
1999	44011	Alcaine	484	0	0	0	1417	420	1000	0	1000	0	0	0
1999	44012	Alcalá de la Selva	628	309	46	263	3662	22	0	0	0	18	0,089	292
1999	44013	Alcañiz	13725	1903	30	1873	31171	990	28302	1762	26540	16	128,726	2194
1999	44014	Alcorisa	3340	210	124	86	12060	146	7303	741	6562	15	1,124	494
1999	44016	Alfambra	2572	76	0	76	19293	903	1912	404	1508	5	0,605	318
1999	44017	Aliaga	1349	729	0	729	8086	101	8	2	6	25	0,49	57
1999	44018	Almohaja	222	0	0	0	2193	29	0	0	0	0	0,018	0
1999	44019	Alobras	369	0	0	0	3433	250	0	0	0	0	0,018	10
1999	44020	Alpeñés	98	0	0	0	983	0	0	0	0	0	0	0
1999	44021	Allepuz	1015	151	0	151	6837	88	1163	304	859	5	0,161	27
1999	44022	Alloza	679	0	0	0	3442	227	993	3	990	2	0,681	78
1999	44023	Allueva	0	0	0	0	0	0	0	0	0	0	0	0
1999	44024	Anadón	96	0	0	0	954	8	0	0	0	0	0	0
1999	44025	Andorra	2875	87	0	87	12474	293	5122	0	5122	8	1,242	92
1999	44026	Arcos de las Salinas	465	0	0	0	4387	175	0	0	0	0	0,01	450
1999	44027	Arens de Lledó	1174	0	0	0	264	8	3325	150	3175	1	20,05	910
1999	44028	Argente	732	0	0	0	4957	3	2600	0	2600	0	0,008	70
1999	44029	Ariño	70	0	0	0	570	126	0	0	0	0	0	0
1999	44031	Azaila	408	199	0	199	863	19	800	0	800	0	0,017	0
1999	44032	Bádenas	107	0	0	0	1018	47	0	0	0	0	0	0
1999	44033	Báguena	1029	0	0	0	2076	4	3387	500	2887	2	0	0
1999	44034	Bañón	1181	0	0	0	3164	0	3086	503	2583	0	0,201	322
1999	44035	Barrachina	528	0	0	0	1487	3	1951	392	1559	0	0,1	140
1999	44036	Bea	168	0	0	0	1625	0	0	0	0	0	0	250
1999	44037	Beceite	4065	312	0	312	834	161	8853	247	8606	1	166,076	878
1999	44038	Belmonte de San José	1811	0	0	0	1085	345	4765	585	4180	0	18,041	88
1999	44039	Bello	654	40	0	40	5617	31	264	63	201	0	0,448	571
1999	44040	Berge	681	3	0	3	2241	69	532	0	532	3	40,253	33
1999	44041	Bezas	12	0	0	0	0	0	4	0	4	4	0,055	353
1999	44042	Blancas	628	0	0	0	3829	0	2292	386	1906	0	0	0
1999	44043	Blesa	190	0	0	0	1825	28	0	0	0	3	0,145	1
1999	44044	Bordón	1946	11	0	11	2591	379	6980	712	6268	6	0,147	16
1999	44045	Bronchales	431	69	0	69	3590	132	15	0	15	0	0,027	0
1999	44046	Bueña	689	0	0	0	3763	282	956	154	802	0	0,104	328
1999	44047	Burbáguena	210	0	0	0	937	230	358	123	235	3	0,213	926
1999	44048	Cabra de Mora	161	0	0	0	1216	38	66	41	25	0	0,133	35
1999	44049	Calaceite	3505	10	0	10	3153	326	9175	315	8860	1	65,757	4276
1999	44050	Calamocha	11450	649	0	649	17259	228	28730	3410	25320	5	0,042	2888
1999	44051	Calanda	6869	0	0	0	5565	182	20340	1545	18795	0	165,016	2261
1999	44052	Calomarde	277	0	0	0	2688	32	8	4	4	0	0,058	7
1999	44053	Camañas	538	0	0	0	5360	13	2	0	2	0	0,025	2
1999	44054	Camarena de la Sierra	266	0	0	0	2319	292	10	0	10	1	0,078	10
1999	44055	Camarillas	266	0	0	0	1997	5	133	29	104	0	0	0
1999	44056	Caminreal	8278	526	0	526	5570	0	26806	3044	23762	1	0,02	619
1999	44059	Cantavieja	5119	1221	0	1221	8707	1305	13312	2024	11288	22	1,435	1434
1999	44060	Cañada de Benatanduz	774	272	0	272	3911	43	640	264	376	2	0,412	49
1999	44061	Cañada de Verich (La)	1075	0	0	0	106	0	4787	736	4051	0	0,01	3
1999	44062	Cañada Vellida	344	0	0	0	3395	25	4	2	2	0	0	0
1999	44063	Cañizar del Olivar	229	59	0	59	1840	0	0	0	0	0	0	0
1999	44064	Cascante del Río	351	0	0	0	3441	5	2	0	2	3	0,167	34
1999	44065	Castejón de Tornos	43	0	0	0	226	12	98	23	75	0	0,139	116
1999	44066	Castel de Cabra	691	400	0	400	2777	61	0	0	0	0	18,059	11
1999	44067	Castelnou	448	0	0	0	4457	21	0	0	0	0	0	0
1999	44068	Castelserás	4983	450	0	450	1939	13	16881	1640	15241	0	0,02	503
1999	44070	Castellar (El)	225	38	0	38	1932	47	0	0	0	2	0,034	20
1999	44071	Castellote	4591	350	0	350	8910	183	11085	540	10545	16	13,782	1400
1999	44074	Cedrillas	1687	302	2	300	5189	30	3627	521	3106	6	0,008	302
1999	44075	Celadas	1287	0	0	0	11764	220	330	85	245	2	0,665	72
1999	44076	Cella	3935	697	95	602	11861	33	7253	1378	5875	50	41,635	1671
1999	44077	Cerollera (La)	416	72	0	72	923	9	970	150	820	0	0	310
1999	44080	Codoñera (La)	2721	0	0	0	2057	193	8605	251	8354	1	24,192	47
1999	44082	Corbalán	460	225	0	225	2920	42	19	0	19	4	0,203	15
1999	44084	Cortes de Aragón	619	0	0	0	673	0	1100	0	1100	0	0,084	2
1999	44085	Cosa	598	0	0	0	4780	3	593	195	398	0	0,18	327
1999	44086	Cretas	4950	109	0	109	3448	27	13603	2503	11100	0	108	4520
1999	44087	Crivillén	272	0	0	0	2628	82	0	0	0	0	0,044	0
1999	44088	Cuba (La)	1344	56	0	56	2	0	3906	701	3205	0	10,023	787
1999	44089	Cubla	157	0	0	0	1452	4	57	16	41	0	0,099	12
1999	44090	Cucalón	207	0	0	0	1895	171	0	0	0	0	0	0
1999	44092	Cuervo (El)	32	0	0	0	294	0	0	0	0	2	0,05	18
1999	44093	Cuevas de Almudén	93	0	0	0	886	14	4	0	4	0	0,092	11
1999	44094	Cuevas Labradas	484	250	0	250	3021	38	113	94	19	1	0,128	28
1999	44096	Ejulve	956	9	0	9	5979	397	1030	0	1030	1	0,034	30
1999	44097	Escorihuela	663	0	0	0	6244	54	58	29	29	5	0,438	85
1999	44099	Escucha	395	10	0	10	2752	57	11	0	11	0	0,209	4890
1999	44100	Estercuel	148	0	0	0	1014	461	0	0	0	0	0	0
1999	44101	Ferreruela de Huerva	1969	0	0	0	438	0	0	0	0	0	275,047	0
1999	44102	Fonfría	265	0	0	0	2654	0	0	0	0	0	0	0
1999	44103	Formiche Alto	412	183	0	183	2342	58	23	2	21	0	0,235	933
1999	44105	Fórnoles	265	0	0	0	718	18	570	20	550	2	0,032	1404
1999	44106	Fortanete	993	387	0	387	4179	52	1129	229	900	6	0,192	381
1999	44107	Foz-Calanda	3352	0	0	0	4016	237	8427	791	7636	0	107	2160
1999	44108	Fresneda (La)	2828	213	0	213	2041	244	5411	351	5060	2	130,079	1163
1999	44109	Frías de Albarracín	725	0	0	0	7199	27	4	4	0	0	0,042	5
1999	44110	Fuenferrada	178	0	0	0	1759	0	2	0	2	0	0,066	21
1999	44111	Fuentes Calientes	747	80	45	35	5112	4	520	0	520	0	0,005	500
1999	44112	Fuentes Claras	4134	257	0	257	4658	15	12351	927	11424	0	0,016	1985
1999	44113	Fuentes de Rubielos	57	48	0	48	144	9	18	16	2	1	0,006	0
1999	44114	Fuentespalda	4552	120	0	120	752	0	12019	1003	11016	1	160,093	536
1999	44115	Galve	397	0	0	0	3898	39	9	5	4	0	0	0
1999	44116	Gargallo	99	0	0	0	985	0	0	0	0	0	0,004	2
1999	44117	Gea de Albarracín	282	0	0	0	2165	15	252	85	167	2	0,17	216
1999	44118	Ginebrosa (La)	4434	239	0	239	9516	653	8515	1228	7287	2	113,355	2057
1999	44119	Griegos	441	0	0	0	4256	154	0	0	0	0	0	0
1999	44120	Guadalaviar	1810	455	0	455	14062	278	0	0	0	22	0,187	1277
1999	44121	Gúdar	823	771	0	771	2705	39	2	2	0	1	0,03	1
1999	44122	Híjar	5623	2635	0	2635	11369	71	11510	850	10660	1	20	480
1999	44123	Hinojosa de Jarque	1038	0	0	0	2756	21	1522	1520	2	0	0,006	2
1999	44124	Hoz de la Vieja (La)	423	0	0	0	4140	36	8	0	8	0	0,202	20
1999	44125	Huesa del Común	311	0	0	0	3004	26	14	8	6	0	0,069	6
1999	44126	Iglesuela del Cid (La)	1136	183	0	183	1845	66	2802	256	2546	9	0,388	63
1999	44127	Jabaloyas	352	0	0	0	3388	86	8	0	8	0	0,1	20
1999	44128	Jarque de la Val	106	0	0	0	1000	4	10	0	10	0	0,15	29
1999	44129	Jatiel	381	0	0	0	683	6	1040	0	1040	0	0,035	0
1999	44130	Jorcas	291	0	0	0	1845	10	469	166	303	0	0,024	2
1999	44131	Josa	86	0	0	0	830	26	0	0	0	0	0,03	12
1999	44132	Lagueruela	144	0	0	0	1255	0	0	0	0	0	0,03	909
1999	44133	Lanzuela	42	0	0	0	199	11	0	0	0	0	0	1050
1999	44135	Libros	118	0	0	0	1126	5	0	0	0	3	0,105	33
1999	44136	Lidón	549	67	40	27	4102	4	168	140	28	0	0,115	16
1999	44137	Linares de Mora	1200	875	0	875	5190	249	112	39	73	1	0,039	2
1999	44138	Loscos	307	100	0	100	2447	59	0	0	0	13	0,382	43
1999	44141	Lledó	2068	0	0	0	772	9	11040	90	10950	0	40	606
1999	44142	Maicas	106	0	0	0	1048	10	0	0	0	0	0,04	2
1999	44143	Manzanera	1115	91	0	91	8123	178	1162	350	812	3	0,351	88
1999	44144	Martín del Río	889	0	0	0	2782	2	1972	0	1972	0	0,249	651
1999	44145	Mas de las Matas	5456	365	23	342	3705	23	16111	916	15195	1	70,223	3702
1999	44146	Mata de los Olmos (La)	1358	0	0	0	2039	23	3830	0	3830	0	0,156	24
1999	44147	Mazaleón	3025	0	0	0	2178	219	12213	2331	9882	3	43,21	1075
1999	44148	Mezquita de Jarque	471	0	0	0	4651	19	2	0	2	0	0,201	21
1999	44149	Mirambel	3846	610	0	610	2511	832	9445	1713	7732	1	0,185	59
1999	44150	Miravete de la Sierra	198	31	0	31	1535	43	44	15	29	1	0,153	17
1999	44151	Molinos	2271	1	0	1	7180	414	5437	660	4777	2	0,568	352
1999	44152	Monforte de Moyuela	441	0	0	0	4328	36	0	0	0	2	0,188	20
1999	44153	Monreal del Campo	3498	1442	0	1442	8698	0	6043	624	5419	8	0,185	1216
1999	44154	Monroyo	10989	339	0	339	2721	164	31847	4494	27353	3	133,526	3950
1999	44155	Montalbán	567	0	0	0	5263	32	0	0	0	0	0	1850
1999	44156	Monteagudo del Castillo	320	259	0	259	1491	11	2	0	2	2	0	0
1999	44157	Monterde de Albarracín	268	0	0	0	2547	76	16	6	10	1	0,095	9
1999	44158	Mora de Rubielos	855	436	0	436	4461	165	139	67	72	2	0,221	34
1999	44159	Moscardón	127	0	0	0	764	356	15	2	13	0	0,042	602
1999	44160	Mosqueruela	1976	657	0	657	7697	507	3131	561	2570	21	0,991	926
1999	44161	Muniesa	1960	205	0	205	7789	84	5403	100	5303	0	0,177	15
1999	44163	Noguera de Albarracín	386	0	0	0	3446	372	0	0	0	5	0,047	2
1999	44164	Nogueras	124	0	0	0	1215	28	0	0	0	0	0	0
1999	44165	Nogueruelas	283	81	0	81	1994	175	5	5	0	1	0,081	19
1999	44167	Obón	234	0	0	0	2226	112	0	0	0	0	0	0
1999	44168	Odón	1785	90	0	90	5965	30	3793	130	3663	0	0,257	1620
1999	44169	Ojos Negros	2200	20	0	20	11485	415	3239	48	3191	2	0	1950
1999	44171	Olba	28	0	0	0	221	26	0	0	0	2	0,079	5
1999	44172	Oliete	968	102	0	102	5886	916	820	0	820	1	0,003	8
1999	44173	Olmos (Los)	394	0	0	0	3553	53	80	30	50	0	0,219	17
1999	44174	Orihuela del Tremedal	483	82	74	8	3891	128	0	0	0	0	0,015	0
1999	44175	Orrios	552	0	0	0	5188	22	92	9	83	0	0,362	53
1999	44176	Palomar de Arroyos	499	0	0	0	2921	45	3	0	3	0	25,048	1300
1999	44177	Pancrudo	706	0	0	0	7039	15	0	0	0	0	0,02	0
1999	44178	Parras de Castellote (Las)	285	0	0	0	2462	69	856	0	856	0	0,077	311
1999	44179	Peñarroya de Tastavins	10610	71	18	53	5452	66	35453	3520	31933	5	55,04	2578
1999	44180	Peracense	146	0	0	0	1322	28	25	14	11	0	0,237	12
1999	44181	Peralejos	317	0	0	0	2715	1	184	80	104	0	0,089	32
1999	44182	Perales del Alfambra	1592	180	0	180	9482	17	1130	0	1130	4	0,272	49
1999	44183	Pitarque	274	59	0	59	2159	54	0	0	0	5	0,087	107
1999	44184	Plou	142	0	0	0	1408	11	0	0	0	0	0,022	0
1999	44185	Pobo (El)	246	96	1	95	1584	17	81	36	45	0	0,099	15
1999	44187	Portellada (La)	3607	1	0	1	2235	19	9611	723	8888	0	104,074	103
1999	44189	Pozondón	227	0	0	0	1997	0	0	0	0	0	0	1375
1999	44190	Pozuel del Campo	259	0	0	0	2319	0	56	46	10	0	0,106	8
1999	44191	Puebla de Híjar (La)	4865	2456	0	2456	5321	48	11156	150	11006	0	0,012	0
1999	44192	Puebla de Valverde (La)	2461	484	0	484	20258	503	71	17	54	15	0,624	83
1999	44193	Puertomingalvo	522	120	0	120	3661	92	219	66	153	5	0,26	94
1999	44194	Ráfales	236	0	0	0	450	152	419	50	369	1	10,004	427
1999	44195	Rillo	245	0	0	0	2441	4	0	0	0	0	0	0
1999	44196	Riodeva	163	0	0	0	1444	2	5	0	5	17	0,204	29
1999	44197	Ródenas	502	0	0	0	3514	4	500	0	500	0	0	0
1999	44198	Royuela	421	84	0	84	3130	70	94	43	51	0	0,212	279
1999	44199	Rubiales	67	0	0	0	637	21	4	0	4	0	0,008	3
1999	44200	Rubielos de la Cérida	212	0	0	0	2095	15	0	0	0	0	0,067	8
1999	44201	Rubielos de Mora	1846	271	66	205	1060	11	5946	815	5131	7	0,081	14
1999	44203	Salcedillo	0	0	0	0	0	0	0	0	0	0	0	0
1999	44204	Saldón	97	0	0	0	965	0	0	0	0	0	0,018	1
1999	44205	Samper de Calanda	5197	675	50	625	12302	247	11043	1623	9420	1	29,129	435
1999	44206	San Agustín	339	30	0	30	3122	59	1	0	1	3	0,349	44
1999	44207	San Martín del Río	773	0	0	0	0	0	0	0	0	0	55	135
1999	44208	Santa Cruz de Nogueras	63	0	0	0	612	22	0	0	0	0	0	0
1999	44209	Santa Eulalia	1767	1	0	1	13148	21	1788	325	1463	23	0,422	276
1999	44210	Sarrión	1051	2	0	2	10202	120	2	0	2	10	0,403	156
1999	44211	Segura de los Baños	137	0	0	0	1318	0	7	0	7	0	0,122	51
1999	44212	Seno	101	0	0	0	973	0	7	0	7	1	0,088	3
1999	44213	Singra	431	0	0	0	3050	0	417	9	408	0	0,072	5
1999	44215	Terriente	1403	813	0	813	3911	96	2037	291	1746	2	0,34	51
1999	44216	Teruel	6089	387	12	375	39513	280	4845	339	4506	29	8,541	1548
1999	44217	Toril y Masegoso	157	0	0	0	1471	36	2	0	2	6	0,066	7
1999	44218	Tormón	1	0	0	0	0	0	0	0	0	0	0,049	4
1999	44219	Tornos	304	80	0	80	2191	17	199	63	136	0	0,479	194
1999	44220	Torralba de los Sisones	3464	142	0	142	8256	12	8472	1215	7257	1	15,006	403
1999	44221	Torrecilla de Alcañiz	2345	600	0	600	1131	6	5376	253	5123	3	64,178	25
1999	44222	Torrecilla del Rebollar	351	0	0	0	3385	5	5	0	5	0	0,19	390
1999	44223	Torre de Arcas	1393	240	0	240	1253	100	3369	159	3210	0	24	420
1999	44224	Torre de las Arcas	213	0	0	0	2052	80	0	0	0	0	0,012	0
1999	44225	Torre del Compte	50	0	0	0	425	0	1	1	0	0	0	340
1999	44226	Torrelacárcel	1133	0	0	0	10790	0	174	70	104	3	0,201	14
1999	44227	Torre los Negros	319	0	0	0	3136	44	0	0	0	1	0	21
1999	44228	Torremocha de Jiloca	283	0	0	0	2793	7	8	5	3	0	0,004	0
1999	44229	Torres de Albarracín	1807	221	37	184	604	16	3203	3113	90	2	0,665	19
1999	44230	Torrevelilla	2417	0	0	0	0	595	8027	612	7415	0	40,022	8
1999	44231	Torrijas	204	0	0	0	2009	10	0	0	0	0	0,072	0
1999	44232	Torrijo del Campo	4864	296	0	296	6296	3	15761	1882	13879	13	0	3600
1999	44234	Tramacastiel	49	0	0	0	480	0	0	0	0	0	0,09	2
1999	44235	Tramacastilla	366	150	0	150	2589	158	60	45	15	3	0,145	18
1999	44236	Tronchón	561	475	0	475	1171	81	220	36	184	4	0,078	10
1999	44237	Urrea de Gaén	510	331	0	331	1088	0	1533	254	1279	1	0,468	644
1999	44238	Utrillas	1446	0	0	0	4903	26	3283	320	2963	1	0,105	10
1999	44239	Valacloche	33	0	0	0	279	0	0	0	0	4	0,092	7
1999	44240	Valbona	1066	76	54	22	971	36	3331	291	3040	0	0,021	0
1999	44241	Valdealgorfa	922	0	0	0	678	31	4806	350	4456	0	23,089	328
1999	44243	Valdecuenca	36	0	0	0	351	8	0	0	0	0	0,012	0
1999	44244	Valdelinares	622	320	0	320	3316	74	0	0	0	31	0,084	34
1999	44245	Valdeltormo	413	0	0	0	716	259	380	130	250	0	25,008	0
1999	44246	Valderrobres	10867	1049	0	1049	8037	188	28427	2275	26152	8	107,082	10286
1999	44247	Valjunquera	737	0	0	0	871	32	1200	0	1200	0	40,08	281
1999	44249	Vallecillo (El)	65	0	0	0	631	13	0	0	0	0	0,015	7
1999	44250	Veguillas de la Sierra	0	0	0	0	0	0	0	0	0	0	0,009	0
1999	44251	Villafranca del Campo	1971	0	0	0	10899	39	2847	269	2578	9	0,005	0
1999	44252	Villahermosa del Campo	518	0	0	0	1555	2	5457	450	5007	0	0,035	0
1999	44256	Villanueva del Rebollar de la Sierra	145	0	0	0	1400	0	9	0	9	0	0,085	41
1999	44257	Villar del Cobo	1147	117	0	117	10296	186	0	0	0	3	0,125	202
1999	44258	Villar del Salz	171	0	0	0	1674	37	0	0	0	0	0	0
1999	44260	Villarluengo	1409	820	0	820	5044	200	809	102	707	21	0,457	481
1999	44261	Villarquemado	4659	2276	136	2140	10004	20	8766	397	8369	3	0,312	329
1999	44262	Villarroya de los Pinares	953	150	0	150	3568	122	1566	20	1546	2	0,213	34
1999	44263	Villastar	348	119	0	119	2301	35	31	1	30	0	0,309	253
1999	44264	Villel	697	0	0	0	6930	10	6	0	6	0	0,076	12
1999	44265	Vinaceite	3460	450	0	450	6559	37	9333	950	8383	0	33,012	0
1999	44266	Visiedo	1167	67	0	67	6567	6	1680	347	1333	1	0,228	47
1999	44267	Vivel del Río Martín	508	0	0	0	2829	0	1004	100	904	0	0,093	512
1999	44268	Zoma (La)	26	0	0	0	259	0	0	0	0	0	0	0
1999	50001	Abanto	329	524	0	524	921	9	160	45	115	0	0,01	0
1999	50002	Acered	224	263	0	263	1061	4	5	0	5	5	0,009	1
1999	50003	Agón	841	78	0	78	1220	0	2330	80	2250	0	0,006	0
1999	50004	Aguarón	1258	0	0	0	254	34	455	150	305	0	143,5	0
1999	50005	Aguilón	518	0	0	0	2027	60	0	0	0	1	44	0
1999	50006	Ainzón	2532	12	0	12	2272	50	7638	1	7637	1	0,173	8
1999	50007	Aladrén	81	0	0	0	527	286	0	0	0	0	0	0
1999	50008	Alagón	2140	1830	243	1587	3380	6	1298	1210	88	4	24,602	0
1999	50009	Alarba	40	0	0	0	370	5	0	0	0	2	0,05	10
1999	50010	Alberite de San Juan	35	50	0	50	0	0	0	0	0	0	0,008	0
1999	50011	Albeta	0	0	0	0	0	0	0	0	0	0	0	0
1999	50012	Alborge	811	349	0	349	1662	0	1582	130	1452	0	0,032	0
1999	50013	Alcalá de Ebro	456	380	190	190	1598	25	0	0	0	1	0,104	0
1999	50014	Alcalá de Moncayo	591	32	0	32	1874	33	1908	300	1608	0	0,044	0
1999	50015	Alconchel de Ariza	1725	90	0	90	3029	0	4620	0	4620	0	0,08	0
1999	50016	Aldehuela de Liestos	120	0	0	0	727	2	239	60	179	0	0,076	0
1999	50017	Alfajarín	2246	901	80	821	9620	37	2550	0	2550	0	0,03	80
1999	50018	Alfamén	6676	0	0	0	5495	26	0	0	0	7	449,025	0
1999	50019	Alforque	6242	0	0	0	549	0	3324	0	3324	0	173	0
1999	50020	Alhama de Aragón	1259	125	0	125	3277	27	0	0	0	8	47	0
1999	50021	Almochuel	594	0	0	0	835	2	1700	0	1700	0	0,018	0
1999	50022	Almolda (La)	5452	364	0	364	7885	150	13899	905	12994	0	71	0
1999	50023	Almonacid de la Cuba	3641	312	35	277	2726	25	8850	400	8450	2	68,125	8
1999	50024	Almonacid de la Sierra	691	0	0	0	0	0	6020	20	6000	0	0	0
1999	50025	Almunia de Doña Godina (La)	10754	2740	0	2740	4947	0	7464	1710	5754	5	547,003	0
1999	50026	Alpartir	2563	0	0	0	1113	16	0	0	0	0	220	0
1999	50027	Ambel	3821	1557	0	1557	2198	11	8865	1300	7565	4	0,008	0
1999	50028	Anento	305	0	0	0	2038	0	397	40	357	0	0	0
1999	50029	Aniñón	3757	8	6	2	2948	52	1000	0	1000	0	450	0
1999	50030	Añón de Moncayo	1100	0	0	0	2864	148	2977	255	2722	0	0,07	2
1999	50031	Aranda de Moncayo	472	0	0	0	4059	562	23	3	20	5	0	0
1999	50032	Arándiga	1248	0	0	0	3759	10	603	80	523	9	100,006	2
1999	50033	Ardisa	23	0	0	0	185	48	0	0	0	0	0	0
1999	50034	Ariza	1678	648	43	605	9999	22	1248	0	1248	0	0,12	383
1999	50035	Artieda	1511	0	0	0	0	0	7307	1150	6157	0	0	0
1999	50036	Asín	148	0	0	0	1323	119	0	0	0	2	0,138	0
1999	50037	Atea	756	0	0	0	2252	247	32	30	2	1	70	0
1999	50038	Ateca	578	60	0	60	1765	10	0	0	0	3	50	0
1999	50039	Azuara	2597	0	0	0	9817	120	4248	0	4248	6	181,405	381
1999	50040	Badules	112	0	0	0	1035	0	300	0	300	0	0	0
1999	50041	Bagüés	0	0	0	0	0	0	0	0	0	0	0	0
1999	50042	Balconchán	0	0	0	0	0	0	0	0	0	0	0	0
1999	50043	Bárboles	1113	300	0	300	3150	0	4692	990	3702	0	0,009	0
1999	50044	Bardallur	285	0	0	0	2818	19	0	0	0	2	0	0
1999	50045	Belchite	4060	1176	0	1176	13254	190	6760	520	6240	11	83,902	514
1999	50046	Belmonte de Gracián	672	0	0	0	1260	183	1946	500	1446	0	0	0
1999	50047	Berdejo	0	0	0	0	0	0	0	0	0	0	0	0
1999	50048	Berrueco	1021	0	0	0	0	0	4320	600	3720	0	0	0
1999	50050	Bijuesca	181	0	0	0	1690	26	0	0	0	12	0	3
1999	50051	Biota	6956	3	0	3	9145	87	21807	1720	20087	0	88,127	4
1999	50052	Bisimbre	504	127	0	127	36	0	1106	0	1106	0	3,537	0
1999	50053	Boquiñeni	11789	0	0	0	1502	1308	37805	3906	33899	0	0,1	0
1999	50054	Bordalba	144	0	0	0	1391	22	1	0	1	0	0,13	0
1999	50055	Borja	2430	1245	4	1241	9522	73	3083	250	2833	29	0,132	550
1999	50056	Botorrita	107	0	0	0	1046	23	0	0	0	0	0	0
1999	50057	Brea de Aragón	288	0	0	0	2815	28	0	0	0	4	0,007	0
1999	50058	Bubierca	498	925	70	855	451	5	0	0	0	1	0,047	0
1999	50059	Bujaraloz	55460	90	0	90	3606	652	21225	1300	19925	0	1699,024	1158
1999	50060	Bulbuente	185	331	0	331	510	0	0	0	0	2	0,048	0
1999	50061	Bureta	330	0	0	0	1196	7	700	0	700	0	0,012	0
1999	50062	Burgo de Ebro (El)	1335	0	0	0	3557	59	7183	450	6733	5	0,054	0
1999	50063	Buste (El)	0	0	0	0	0	0	0	0	0	0	0	0
1999	50064	Cabañas de Ebro	394	490	0	490	682	8	0	0	0	11	0	0
1999	50065	Cabolafuente	433	0	0	0	1745	3	820	0	820	1	0	550
1999	50066	Cadrete	133	0	0	0	484	9	0	0	0	0	12	0
1999	50067	Calatayud	1643	584	0	584	7733	106	1730	131	1599	34	0,138	726
1999	50068	Calatorao	5358	141	66	75	3801	5	26183	4544	21639	7	0,017	0
1999	50069	Calcena	142	0	0	0	1417	0	0	0	0	0	0	0
1999	50070	Calmarza	146	0	0	0	1397	30	0	0	0	4	0	0
1999	50071	Campillo de Aragón	173	0	0	0	1700	7	0	0	0	3	0	0
1999	50072	Carenas	141	0	0	0	1400	6	0	0	0	1	0	0
1999	50073	Cariñena	2743	0	0	0	2428	45	11553	2003	9550	0	44,5	917
1999	50074	Caspe	33554	573	29	544	43072	2075	120339	14362	105977	14	311,018	3220
1999	50075	Castejón de Alarba	247	0	0	0	536	5	580	230	350	0	0	0
1999	50076	Castejón de las Armas	0	0	0	0	0	0	0	0	0	0	0	0
1999	50077	Castejón de Valdejasa	847	150	0	150	1675	77	1867	71	1796	0	0,036	2
1999	50078	Castiliscar	417	0	0	0	4134	27	3	0	3	0	0,021	0
1999	50079	Cervera de la Cañada	416	0	0	0	2219	12	600	60	540	0	0,2	3
1999	50080	Cerveruela	45	0	0	0	450	0	0	0	0	0	0	0
1999	50081	Cetina	1633	445	1	444	9904	116	1313	10	1303	1	0,119	0
1999	50082	Cimballa	98	0	0	0	887	3	25	16	9	0	0	0
1999	50083	Cinco Olivas	561	0	0	0	714	0	0	0	0	0	70	0
1999	50084	Clarés de Ribota	111	2	0	2	1059	9	5	5	0	0	0	0
1999	50085	Codo	28	0	0	0	268	5	0	0	0	0	0,039	0
1999	50086	Codos	849	0	0	0	3031	456	1000	1000	0	0	0	0
1999	50087	Contamina	79	0	0	0	785	6	0	0	0	0	0	0
1999	50088	Cosuenda	1065	0	0	0	402	0	1200	0	1200	0	95	0
1999	50089	Cuarte de Huerva	41	0	0	0	0	0	245	70	175	0	0	0
1999	50090	Cubel	1001	604	0	604	2378	28	1854	440	1414	0	0	350
1999	50091	Cuerlas (Las)	95	0	0	0	936	10	0	0	0	0	0,035	0
1999	50092	Chiprana	299	0	0	0	2957	29	0	0	0	0	0	0
1999	50093	Chodes	96	90	0	90	315	9	0	0	0	1	0	0
1999	50094	Daroca	2988	0	0	0	3135	5	4800	850	3950	1	114,072	804
1999	50095	Ejea de los Caballeros	63549	1941	52	1889	90540	1594	190370	23266	167104	20	166,159	1623
1999	50096	Embid de Ariza	663	0	0	0	1617	250	1583	314	1269	0	0	0
1999	50098	Encinacorba	273	0	0	0	1192	0	872	260	612	4	0,036	0
1999	50099	Épila	6023	1149	0	1149	30081	391	9730	480	9250	0	0,22	0
1999	50100	Erla	2326	0	0	0	2913	38	7690	970	6720	0	0	0
1999	50101	Escatrón	616	0	0	0	2765	79	1104	0	1104	0	0,034	0
1999	50102	Fabara	9598	302	20	282	3088	63	33516	6056	27460	2	100,7	8848
1999	50104	Farlete	2607	0	0	0	17035	362	3772	829	2943	13	0,227	0
1999	50105	Fayón	1845	0	0	0	0	0	4866	0	4866	0	55	0
1999	50106	Fayos (Los)	0	0	0	0	0	0	0	0	0	0	0	0
1999	50107	Figueruelas	667	96	0	96	586	7	1750	750	1000	4	20	0
1999	50108	Fombuena	266	149	0	149	1651	8	0	0	0	0	0	0
1999	50109	Frago (El)	48	0	0	0	422	56	0	0	0	0	0	0
1999	50110	Frasno (El)	143	0	0	0	681	21	0	0	0	4	10	0
1999	50111	Fréscano	665	707	0	707	367	0	860	0	860	3	0	0
1999	50113	Fuendejalón	1576	0	0	0	6200	8	3104	400	2704	0	0,012	0
1999	50114	Fuendetodos	1000	0	0	0	298	1096	2000	0	2000	2	37	0
1999	50115	Fuentes de Ebro	4421	1013	27	986	8917	63	7776	40	7736	2	105,836	3
1999	50116	Fuentes de Jiloca	1051	700	0	700	1982	13	1282	291	991	3	20,078	434
1999	50117	Gallocanta	1440	0	0	0	1332	6	5651	864	4787	0	0,012	100
1999	50118	Gallur	1437	51	0	51	3267	12	4236	702	3534	3	1	280
1999	50119	Gelsa	11678	2076	0	2076	3661	30	25370	0	25370	0	191,5	0
1999	50120	Godojos	604	0	0	0	1417	32	0	0	0	5	65	0
1999	50121	Gotor	32	0	0	0	318	2	0	0	0	0	0,008	0
1999	50122	Grisel	8	0	0	0	0	0	0	0	0	0	0	400
1999	50123	Grisén	102	0	0	0	1019	0	0	0	0	0	0	0
1999	50124	Herrera de los Navarros	2956	220	0	220	12824	97	3037	784	2253	1	126	0
1999	50125	Ibdes	2389	21	0	21	2670	25	5930	852	5078	0	80	0
1999	50126	Illueca	181	0	0	0	1745	3	0	0	0	7	0,056	4
1999	50128	Isuerre	170	0	0	0	1504	30	25	1	24	4	0,06	3
1999	50129	Jaraba	283	0	0	0	2770	32	0	0	0	4	0	0
1999	50130	Jarque de Moncayo	1194	0	0	0	3888	33	1353	51	1302	12	45,071	10
1999	50131	Jaulín	1377	0	0	0	2272	25	500	0	500	2	128	0
1999	50132	Joyosa (La)	1308	3061	86	2975	0	0	4	0	4	0	0	0
1999	50133	Lagata	333	105	0	105	943	11	650	0	650	1	0,021	0
1999	50134	Langa del Castillo	1797	0	0	0	854	60	5940	300	5640	0	0	0
1999	50135	Layana	320	90	0	90	1252	13	520	0	520	2	0	0
1999	50136	Lécera	2890	140	80	60	5331	160	6392	150	6242	9	52	0
1999	50137	Leciñena	14179	303	0	303	9002	234	39940	120	39820	4	135	2750
1999	50138	Lechón	82	0	0	0	239	0	354	100	254	0	0	0
1999	50139	Letux	1103	1016	50	966	2116	52	444	154	290	2	45,415	17
1999	50140	Litago	157	0	0	0	1227	36	83	39	44	1	0,186	8
1999	50141	Lituénigo	93	0	0	0	901	20	1	1	0	0	0,032	6
1999	50142	Lobera de Onsella	190	0	0	0	1836	63	0	0	0	0	0	0
1999	50143	Longares	454	141	0	141	977	12	850	90	760	14	0	230
1999	50144	Longás	55	0	0	0	498	51	0	0	0	0	0	0
1999	50146	Lucena de Jalón	622	240	0	240	1001	18	2266	404	1862	0	0,013	3
1999	50147	Luceni	2518	969	8	961	5680	2	5318	220	5098	1	0,391	13
1999	50148	Luesia	3659	235	0	235	6034	351	10223	485	9738	4	0,569	22
1999	50149	Luesma	550	1023	0	1023	1263	23	0	0	0	0	0	0
1999	50150	Lumpiaque	1543	0	0	0	3014	28	5001	763	4238	2	0,086	317
1999	50151	Luna	9423	594	0	594	21416	837	20453	640	19813	5	100,01	801
1999	50152	Maella	4193	0	0	0	3118	25	11260	407	10853	3	51,953	1160
1999	50153	Magallón	5309	472	0	472	3679	24	20310	600	19710	0	0,056	0
1999	50154	Mainar	1733	0	0	0	3330	0	0	0	0	0	100	0
1999	50155	Malanquilla	153	0	0	0	1525	0	0	0	0	0	0	0
1999	50156	Maleján	0	0	0	0	0	0	0	0	0	0	0	0
1999	50157	Malón	840	0	0	0	0	0	840	240	600	0	30,006	7
1999	50159	Maluenda	716	0	0	0	691	0	0	0	0	21	45	0
1999	50160	Mallén	6004	361	70	291	3432	37	18609	502	18107	1	9,01	0
1999	50161	Manchones	628	0	0	0	407	0	3163	920	2243	0	0	0
1999	50162	Mara	202	0	0	0	1662	14	238	54	184	2	0	0
1999	50163	María de Huerva	3846	1225	0	1225	6941	84	2456	496	1960	1	147	0
1999	50164	Mediana de Aragón	1782	704	0	704	12405	98	803	250	553	2	0,314	5
1999	50165	Mequinenza	5948	0	0	0	4328	951	11010	0	11010	0	295,028	2610
1999	50166	Mesones de Isuela	1805	0	0	0	11978	113	3478	330	3148	2	30,024	200
1999	50167	Mezalocha	708	0	0	0	1059	0	1072	100	972	1	27,275	10
1999	50168	Mianos	121	0	0	0	1153	11	9	2	7	0	0,02	2
1999	50169	Miedes de Aragón	1140	0	0	0	2048	309	2509	282	2227	0	66,5	200
1999	50170	Monegrillo	2530	0	0	0	18947	738	2657	634	2023	4	0,027	0
1999	50171	Moneva	901	1326	34	1292	3094	64	0	0	0	0	0,044	6
1999	50172	Monreal de Ariza	1070	552	0	552	7614	25	240	0	240	0	0,008	320
1999	50173	Monterde	407	0	0	0	3322	19	0	0	0	0	0	3634
1999	50174	Montón	19	0	0	0	164	0	3	0	3	0	0,076	5
1999	50175	Morata de Jalón	968	0	0	0	1991	47	663	379	284	1	80,033	0
1999	50176	Morata de Jiloca	76	0	0	0	661	2	5	0	5	3	0,357	28
1999	50177	Morés	230	0	0	0	1310	0	0	0	0	1	14,024	0
1999	50178	Moros	599	0	0	0	1367	4	1580	150	1430	9	0	0
1999	50179	Moyuela	1725	370	0	370	3290	0	3431	191	3240	0	79,745	2
1999	50180	Mozota	180	0	0	0	540	0	0	0	0	0	18	0
1999	50181	Muel	3140	125	0	125	5366	60	4550	0	4550	8	144,01	0
1999	50182	Muela (La)	887	153	0	153	7347	21	1800	0	1800	3	0,044	1870
1999	50183	Munébrega	245	284	0	284	961	8	0	0	0	1	0	0
1999	50184	Murero	328	0	0	0	0	0	965	450	515	0	0	0
1999	50185	Murillo de Gállego	182	0	0	0	1542	272	0	0	0	1	0	0
1999	50186	Navardún	250	0	0	0	2448	56	0	0	0	0	0	0
1999	50187	Nigüella	166	0	0	0	1336	11	59	56	3	0	0	100
1999	50188	Nombrevilla	97	100	0	100	190	0	0	0	0	0	0	0
1999	50189	Nonaspe	6771	0	0	0	2008	28	23756	1740	22016	0	25,034	2355
1999	50190	Novallas	567	0	0	0	977	6	976	136	840	1	18,02	201
1999	50191	Novillas	3071	1317	128	1189	5371	34	6985	498	6487	3	0,006	0
1999	50192	Nuévalos	358	24	2	22	2327	22	0	0	0	2	15	0
1999	50193	Nuez de Ebro	1368	0	0	0	879	4	2000	160	1840	0	82	0
1999	50194	Olvés	40	0	0	0	0	380	0	0	0	2	0	0
1999	50195	Orcajo	0	0	0	0	0	0	0	0	0	0	0	0
1999	50196	Orera	36	0	0	0	361	0	0	0	0	0	0	0
1999	50197	Orés	349	0	0	0	2886	114	290	72	218	1	0,195	7
1999	50198	Oseja	0	0	0	0	0	0	0	0	0	0	0	0
1999	50199	Osera de Ebro	460	350	0	350	1096	0	0	0	0	0	30,024	0
1999	50200	Paniza	662	0	0	0	1479	12	1700	0	1700	3	0,02	5
1999	50201	Paracuellos de Jiloca	139	0	0	0	1250	143	0	0	0	0	0,06	0
1999	50202	Paracuellos de la Ribera	6	0	0	0	50	0	0	0	0	1	0	0
1999	50203	Pastriz	642	450	0	450	0	0	0	0	0	1	50,008	0
1999	50204	Pedrola	2783	1482	180	1302	9556	73	5025	1410	3615	2	0,234	1
1999	50205	Pedrosas (Las)	140	0	0	0	1362	40	0	0	0	0	0	0
1999	50206	Perdiguera	2491	190	0	190	2869	24	4110	381	3729	2	86,01	0
1999	50207	Piedratajada	118	290	0	290	15	0	0	0	0	0	0	0
1999	50208	Pina de Ebro	5285	3239	160	3079	14125	94	5656	0	5656	3	51,035	15
1999	50209	Pinseque	2136	1866	227	1639	4582	15	0	0	0	0	75,012	0
1999	50210	Pintanos (Los)	640	118	0	118	5415	135	0	0	0	1	0	0
1999	50211	Plasencia de Jalón	1697	100	0	100	2015	0	2900	0	2900	0	75	0
1999	50212	Pleitas	61	0	0	0	601	6	0	0	0	0	0	0
1999	50213	Plenas	316	100	0	100	868	0	1505	0	1505	2	16,212	0
1999	50214	Pomer	70	0	0	0	688	0	0	0	0	1	0	0
1999	50215	Pozuel de Ariza	9	13	0	13	0	1	0	0	0	0	0,004	0
1999	50216	Pozuelo de Aragón	1632	48	0	48	1204	9	6224	1230	4994	0	0	0
1999	50217	Pradilla de Ebro	1090	550	0	550	3151	15	1606	154	1452	0	10,5	0
1999	50218	Puebla de Albortón	974	1492	0	1492	2928	99	1000	0	1000	1	0,026	0
1999	50219	Puebla de Alfindén (La)	945	350	0	350	3118	13	0	0	0	2	70	0
1999	50220	Puendeluna	0	0	0	0	0	0	0	0	0	0	0	0
1999	50221	Purujosa	0	0	0	0	0	0	0	0	0	0	0	0
1999	50222	Quinto	11757	2310	385	1925	29511	709	16340	800	15540	4	95,018	0
1999	50223	Remolinos	2655	893	0	893	810	11	6823	8	6815	4	0,159	2
1999	50224	Retascón	452	0	0	0	923	0	1200	0	1200	0	0	0
1999	50225	Ricla	5190	116	0	116	5387	153	3614	400	3214	5	520,016	0
1999	50227	Romanos	650	0	0	0	1473	0	2100	200	1900	0	0	0
1999	50228	Rueda de Jalón	1056	45	0	45	4100	15	2840	400	2440	1	0	0
1999	50229	Ruesca	327	0	0	0	365	260	880	0	880	0	0,01	0
1999	50230	Sádaba	7203	420	0	420	12673	667	19584	2274	17310	2	35,383	609
1999	50231	Salillas de Jalón	67	0	0	0	650	14	0	0	0	1	0	0
1999	50232	Salvatierra de Esca	776	92	0	92	2645	102	1908	325	1583	4	0,007	0
1999	50233	Samper del Salz	50	91	0	91	0	0	0	0	0	0	0,016	0
1999	50234	San Martín de la Virgen de Moncayo	595	0	0	0	1648	0	2249	703	1546	0	0,012	2
1999	50235	San Mateo de Gállego	7004	1178	0	1178	4977	68	21270	2578	18692	5	148	0
1999	50236	Santa Cruz de Grío	149	0	0	0	1463	0	0	0	0	2	0,08	0
1999	50237	Santa Cruz de Moncayo	1291	0	0	0	0	0	2485	211	2274	0	90	0
1999	50238	Santa Eulalia de Gállego	346	0	0	0	442	13	1000	0	1000	0	0	0
1999	50239	Santed	0	0	0	0	0	0	0	0	0	0	0	0
1999	50240	Sástago	17526	493	0	493	16036	359	12415	0	12415	0	775,323	339
1999	50241	Saviñán	117	25	0	25	479	0	184	24	160	0	0	400
1999	50242	Sediles	1	0	0	0	0	0	0	0	0	1	0	0
1999	50243	Sestrica	235	80	0	80	1697	15	0	0	0	8	0,079	3
1999	50244	Sierra de Luna	1237	0	0	0	3312	55	3000	0	3000	0	0	0
1999	50245	Sigüés	332	0	0	0	3014	179	55	18	37	0	0,007	0
1999	50246	Sisamón	363	0	0	0	1037	0	0	0	0	0	37	0
1999	50247	Sobradiel	827	460	150	310	2631	24	675	25	650	0	0	0
1999	50248	Sos del Rey Católico	1453	548	8	540	10657	256	58	20	38	0	0	0
1999	50249	Tabuenca	1329	0	0	0	5214	381	3449	1170	2279	0	0,006	3
1999	50250	Talamantes	77	0	0	0	772	0	0	0	0	0	0	0
1999	50251	Tarazona	7448	350	0	350	20041	763	13040	2512	10528	34	199,284	6
1999	50252	Tauste	51995	7368	1910	5458	66754	906	162776	33569	129207	10	0,26	16
1999	50253	Terrer	254	0	0	0	2469	26	0	0	0	5	0,034	0
1999	50254	Tierga	552	0	0	0	4269	17	618	217	401	4	0,035	3
1999	50255	Tobed	530	0	0	0	728	80	1425	400	1025	1	30,012	0
1999	50256	Torralba de los Frailes	307	0	0	0	3050	16	0	0	0	0	0	0
1999	50257	Torralba de Ribota	126	1	1	0	1098	4	0	0	0	19	0	0
1999	50258	Torralbilla	107	0	0	0	1068	3	0	0	0	0	0	0
1999	50259	Torrehermosa	446	190	0	190	2648	4	0	0	0	0	15	0
1999	50260	Torrelapaja	23	0	0	0	222	6	0	0	0	0	0	0
1999	50261	Torrellas	959	913	0	913	338	12	652	0	652	7	51,031	0
1999	50262	Torres de Berrellén	410	0	0	0	3964	90	0	0	0	4	0,022	40
1999	50263	Torrijo de la Cañada	1553	8	0	8	4484	13	3000	400	2600	10	0	0
1999	50264	Tosos	851	0	0	0	3749	44	1095	140	955	2	24	0
1999	50265	Trasmoz	96	0	0	0	817	40	46	11	35	0	0,167	29
1999	50266	Trasobares	391	0	0	0	2386	62	657	201	456	26	0,101	15
1999	50267	Uncastillo	3681	270	0	270	10357	906	8019	0	8019	2	0,201	0
1999	50268	Undués de Lerda	97	0	0	0	944	29	0	0	0	0	0	0
1999	50269	Urrea de Jalón	80	0	0	0	800	0	0	0	0	0	0	0
1999	50270	Urriés	68	0	0	0	649	28	0	0	0	0	0	0
1999	50271	Used	2291	0	0	0	2296	661	7131	1218	5913	0	0,012	0
1999	50272	Utebo	559	361	31	330	2822	23	0	0	0	3	0,077	0
1999	50273	Valdehorna	43	0	0	0	411	0	0	0	0	2	0	0
1999	50274	Val de San Martín	126	0	0	0	1264	0	0	0	0	0	0	0
1999	50275	Valmadrid	43	0	0	0	420	10	0	0	0	0	0	0
1999	50276	Valpalmas	257	0	0	0	110	9	0	0	0	0	35	0
1999	50277	Valtorres	0	0	0	0	0	0	0	0	0	0	0	0
1999	50278	Velilla de Ebro	1703	982	0	982	3469	0	2650	0	2650	0	0	0
1999	50279	Velilla de Jiloca	90	0	0	0	874	14	0	0	0	1	0,008	0
1999	50280	Vera de Moncayo	1099	90	0	90	1938	19	5302	633	4669	0	0	0
1999	50281	Vierlas	0	0	0	0	0	0	0	0	0	0	0	0
1999	50282	Vilueña (La)	0	0	0	0	0	0	0	0	0	0	0	0
1999	50283	Villadoz	105	0	0	0	1048	0	0	0	0	0	0	0
1999	50284	Villafeliche	66	0	0	0	561	15	0	0	0	3	0,018	270
1999	50285	Villafranca de Ebro	385	137	0	137	1301	16	560	180	380	8	0,227	4
1999	50286	Villalba de Perejil	178	0	0	0	607	0	0	0	0	0	15	600
1999	50287	Villalengua	384	0	0	0	3829	14	0	0	0	0	0	0
1999	50288	Villanueva de Gállego	6372	262	0	262	8440	163	31920	6150	25770	14	40,008	0
1999	50289	Villanueva de Jiloca	0	0	0	0	0	0	0	0	0	0	0	0
1999	50290	Villanueva de Huerva	1110	0	0	0	5842	216	0	0	0	0	72	0
1999	50291	Villar de los Navarros	808	0	0	0	4086	49	894	260	634	1	33	0
1999	50292	Villarreal de Huerva	3435	0	0	0	1104	0	0	0	0	0	275	0
1999	50293	Villarroya de la Sierra	436	185	100	85	1987	17	240	0	240	2	0,17	3
1999	50294	Villarroya del Campo	572	0	0	0	21	0	1900	0	1900	0	0	0
1999	50295	Vistabella	0	0	0	0	0	0	0	0	0	0	0	0
1999	50296	Zaida (La)	213	0	0	0	2087	24	0	0	0	0	0	100
1999	50297	Zaragoza	21884	11817	1829	9988	54035	589	30102	631	29471	310	226,92	1719
1999	50298	Zuera	6474	2653	406	2247	23236	262	10032	1265	8767	19	31,09	0
1999	50901	Biel	442	265	0	265	1013	128	425	0	425	22	0,039	124
1999	50902	Marracos	244	50	0	50	927	12	420	20	400	0	0	0