Año	Código del municipio	Nombre del municipio	Personas que son mano de obra familiar	Personas mano obra familiar sólo trabajan en la explotación	Personas mano obra familiar trabajan también en otra activ. lucrativa	Personas mano obra familiar trabajan en otra actividad como principal	Personas mano obra familiar trabajan en otra actividad como secundaria	Personas mano obra familiar titulares que sólo trabajan en la explotación	Personas mano obra familiar titulares que trabajan también en otra activ. lucrativa	Personas mano obra familiar titulares que trabajan en otra actividad como principal	Personas mano obra familiar titulares que trabajan en otra actividad como secundaria	Personas mano obra familiar cónyuges que sólo trabajan en la explotación	Personas mano obra familiar cónyuges que trabajan también en otra activ. Lucrativa	Personas mano obra familiar cónyuges que trabajan en otra actividad como principal	Personas mano obra familiar cónyuges que trabajan en otra actividad como secundaria	Personas mano obra familiar otros, que sólo trabajan en la explotación	Personas mano obra familiar otros, que  trabajan también en otra activ. lucrativa	Personas mano obra familiar otros,  trabajan en otra actividad como principal	Personas mano obra familiar otros, que trabajan en otra actividad como secundaria	Personas mano obra familiar con <25% trabajando en explotación	Personas mano obra familiar con >24,99 y <50% trabajando en explotación	Personas mano obra familiar con >49,99 y <75% trabajando en explotación	Personas mano obra familiar con >74,99 y <100% trabajando en explotación	Personas mano obra familiar con 100% trabajando en explotación
1989	22001	Abiego	124	100	24	21	3	63	20	18	2	30	2	1	1	7	2	2	0	37	37	0	7	43
1989	22002	Abizanda	53	32	21	20	1	25	14	13	1	1	0	0	0	6	7	7	0	25	10	0	0	18
1989	22003	Adahuesca	69	51	18	17	1	48	18	17	1	1	0	0	0	2	0	0	0	32	15	13	1	8
1989	22004	Agüero	62	46	16	15	1	44	15	15	0	0	0	0	0	2	1	0	1	48	5	0	3	6
1989	22006	Aísa	63	46	17	15	2	32	13	11	2	13	1	1	0	1	3	3	0	27	13	5	2	16
1989	22007	Albalate de Cinca	448	297	151	121	30	195	93	76	17	49	13	6	7	53	45	39	6	231	58	21	23	115
1989	22008	Albalatillo	24	16	8	7	1	15	8	7	1	1	0	0	0	0	0	0	0	16	2	2	1	3
1989	22009	Albelda	595	474	121	83	38	216	64	42	22	121	13	11	2	137	44	30	14	226	94	46	13	216
1989	22011	Albero Alto	29	27	2	2	0	22	1	1	0	0	0	0	0	5	1	1	0	4	16	8	1	0
1989	22012	Albero Bajo	53	31	22	16	6	21	15	11	4	6	0	0	0	4	7	5	2	34	5	5	6	3
1989	22013	Alberuela de Tubo	102	88	14	11	3	63	9	7	2	12	0	0	0	13	5	4	1	25	34	16	16	11
1989	22014	Alcalá de Gurrea	39	30	9	7	2	24	7	5	2	0	0	0	0	6	2	2	0	14	1	3	2	19
1989	22015	Alcalá del Obispo	108	87	21	21	0	81	18	18	0	1	0	0	0	5	3	3	0	57	11	13	25	2
1989	22016	Alcampell	426	352	74	44	30	194	44	26	18	102	7	4	3	56	23	14	9	191	73	49	84	29
1989	22017	Alcolea de Cinca	373	229	144	131	13	179	111	98	13	18	2	2	0	32	31	31	0	215	34	13	11	100
1989	22018	Alcubierre	148	129	19	14	5	108	15	13	2	7	0	0	0	14	4	1	3	80	6	1	0	61
1989	22019	Alerre	17	6	11	9	2	6	11	9	2	0	0	0	0	0	0	0	0	10	2	4	1	0
1989	22020	Alfántega	44	29	15	12	3	17	12	10	2	8	1	1	0	4	2	1	1	25	3	2	3	11
1989	22021	Almudévar	622	344	278	268	10	284	241	234	7	17	5	5	0	43	32	29	3	417	50	20	85	50
1989	22022	Almunia de San Juan	124	86	38	37	1	69	35	34	1	8	0	0	0	9	3	3	0	71	15	8	5	25
1989	22023	Almuniente	149	101	48	42	6	84	41	35	6	5	2	2	0	12	5	5	0	69	17	13	34	16
1989	22024	Alquézar	112	89	23	22	1	79	17	16	1	4	0	0	0	6	6	6	0	43	29	17	7	16
1989	22025	Altorricón	531	370	161	148	13	198	94	86	8	101	16	14	2	71	51	48	3	243	47	31	34	176
1989	22027	Angüés	127	110	17	17	0	95	12	12	0	1	0	0	0	14	5	5	0	80	9	24	14	0
1989	22028	Ansó	33	31	2	2	0	24	1	1	0	1	0	0	0	6	1	1	0	5	1	0	1	26
1989	22029	Antillón	48	41	7	6	1	32	6	5	1	6	0	0	0	3	1	1	0	21	10	10	2	5
1989	22032	Aragüés del Puerto	38	27	11	11	0	19	4	4	0	2	2	2	0	6	5	5	0	9	2	6	4	17
1989	22035	Arén	108	89	19	18	1	61	16	15	1	11	0	0	0	17	3	3	0	27	19	8	0	54
1989	22036	Argavieso	45	36	9	9	0	32	8	8	0	1	0	0	0	3	1	1	0	18	10	8	9	0
1989	22037	Arguis	16	10	6	6	0	10	5	5	0	0	1	1	0	0	0	0	0	11	0	1	0	4
1989	22039	Ayerbe	245	138	107	99	8	125	90	84	6	0	0	0	0	13	17	15	2	170	20	15	34	6
1989	22040	Azanuy-Alins	100	74	26	22	4	71	25	21	4	1	0	0	0	2	1	1	0	57	7	2	3	31
1989	22041	Azara	85	61	24	24	0	35	24	24	0	25	0	0	0	1	0	0	0	42	29	1	1	12
1989	22042	Azlor	73	51	22	21	1	36	20	19	1	10	0	0	0	5	2	2	0	34	21	1	3	14
1989	22043	Baells	59	52	7	4	3	48	5	3	2	4	0	0	0	0	2	1	1	15	10	5	2	27
1989	22044	Bailo	107	80	27	23	4	66	24	21	3	8	0	0	0	6	3	2	1	44	11	11	7	34
1989	22045	Baldellou	84	52	32	28	4	45	26	23	3	0	1	1	0	7	5	4	1	60	4	1	9	10
1989	22046	Ballobar	336	265	71	53	18	135	41	27	14	50	3	3	0	80	27	23	4	153	51	26	2	104
1989	22047	Banastás	6	5	1	1	0	5	1	1	0	0	0	0	0	0	0	0	0	3	0	1	2	0
1989	22048	Barbastro	819	493	326	323	3	393	259	256	3	57	8	8	0	43	59	59	0	577	115	33	62	32
1989	22049	Barbués	53	32	21	18	3	27	18	15	3	3	0	0	0	2	3	3	0	22	8	6	11	6
1989	22050	Barbuñales	35	18	17	14	3	17	14	12	2	1	0	0	0	0	3	2	1	27	2	6	0	0
1989	22051	Bárcabo	58	36	22	20	2	24	15	13	2	7	0	0	0	5	7	7	0	31	10	3	5	9
1989	22052	Belver de Cinca	399	241	158	119	39	161	93	67	26	33	1	1	0	47	64	51	13	217	30	39	104	9
1989	22053	Benabarre	298	234	64	50	14	157	48	39	9	47	3	3	0	30	13	8	5	155	44	21	45	33
1989	22054	Benasque	70	57	13	12	1	45	12	12	0	7	1	0	1	5	0	0	0	33	12	4	5	16
1989	22055	Berbegal	119	96	23	20	3	66	22	20	2	22	0	0	0	8	1	0	1	58	8	9	10	34
1989	22057	Bielsa	116	103	13	13	0	76	13	13	0	16	0	0	0	11	0	0	0	75	12	9	4	16
1989	22058	Bierge	193	134	59	58	1	117	54	53	1	15	1	1	0	2	4	4	0	148	13	4	4	24
1989	22059	Biescas	344	237	107	98	9	124	53	50	3	88	10	7	3	25	44	41	3	243	48	9	2	42
1989	22060	Binaced	529	412	117	99	18	178	52	39	13	98	11	11	0	136	54	49	5	266	71	26	42	124
1989	22061	Binéfar	244	167	77	71	6	115	59	53	6	38	2	2	0	14	16	16	0	112	33	23	50	26
1989	22062	Bisaurri	86	77	9	8	1	48	6	5	1	21	0	0	0	8	3	3	0	12	27	8	0	39
1989	22063	Biscarrués	74	62	12	11	1	58	12	11	1	0	0	0	0	4	0	0	0	35	8	0	7	24
1989	22064	Blecua y Torres	64	44	20	20	0	39	16	16	0	0	0	0	0	5	4	4	0	32	1	7	15	9
1989	22066	Boltaña	97	70	27	23	4	59	23	20	3	3	0	0	0	8	4	3	1	67	3	4	1	22
1989	22067	Bonansa	30	28	2	2	0	14	1	1	0	7	1	1	0	7	0	0	0	0	11	1	2	16
1989	22068	Borau	31	23	8	8	0	21	7	7	0	2	0	0	0	0	1	1	0	18	4	0	4	5
1989	22069	Broto	191	103	88	73	15	64	77	70	7	21	1	0	1	18	10	3	7	106	17	14	19	35
1989	22072	Caldearenas	78	43	35	31	4	37	20	18	2	1	1	1	0	5	14	12	2	44	4	9	13	8
1989	22074	Campo	40	30	10	9	1	25	10	9	1	3	0	0	0	2	0	0	0	26	1	0	0	13
1989	22075	Camporrells	156	104	52	44	8	83	40	36	4	8	1	1	0	13	11	7	4	100	10	10	5	31
1989	22076	Canal de Berdún	147	128	19	19	0	98	17	17	0	13	0	0	0	17	2	2	0	43	17	16	11	60
1989	22077	Candasnos	110	76	34	27	7	60	31	24	7	0	0	0	0	16	3	3	0	40	12	10	8	40
1989	22078	Canfranc	5	4	1	1	0	2	1	1	0	2	0	0	0	0	0	0	0	1	0	0	0	4
1989	22079	Capdesaso	56	45	11	6	5	36	8	3	5	4	1	1	0	5	2	2	0	17	7	12	13	7
1989	22080	Capella	175	129	46	34	12	104	40	31	9	19	0	0	0	6	6	3	3	103	30	3	0	39
1989	22081	Casbas de Huesca	185	140	45	43	2	105	36	34	2	26	1	1	0	9	8	8	0	94	26	7	1	57
1989	22082	Castejón del Puente	86	59	27	22	5	53	26	21	5	3	0	0	0	3	1	1	0	46	6	5	5	24
1989	22083	Castejón de Monegros	199	142	57	50	7	119	48	42	6	2	1	1	0	21	8	7	1	106	16	13	22	42
1989	22084	Castejón de Sos	70	58	12	10	2	48	11	10	1	8	0	0	0	2	1	0	1	40	4	7	2	17
1989	22085	Castelflorite	64	50	14	8	6	40	12	6	6	5	0	0	0	5	2	2	0	15	9	5	1	34
1989	22086	Castiello de Jaca	42	38	4	2	2	18	3	1	2	16	1	1	0	4	0	0	0	6	5	2	12	17
1989	22087	Castigaleu	33	29	4	4	0	20	3	3	0	6	0	0	0	3	1	1	0	14	5	0	0	14
1989	22088	Castillazuelo	96	63	33	31	2	60	29	27	2	0	0	0	0	3	4	4	0	50	25	10	8	3
1989	22089	Castillonroy	212	167	45	30	15	75	22	12	10	45	6	5	1	47	17	13	4	101	35	23	9	44
1989	22090	Colungo	94	67	27	27	0	52	13	13	0	12	0	0	0	3	14	14	0	67	7	5	15	0
1989	22094	Chalamera	72	63	9	7	2	34	3	2	1	8	0	0	0	21	6	5	1	26	4	8	1	33
1989	22095	Chía	37	34	3	3	0	23	1	1	0	7	0	0	0	4	2	2	0	3	14	1	0	19
1989	22096	Chimillas	19	13	6	6	0	13	6	6	0	0	0	0	0	0	0	0	0	5	3	9	2	0
1989	22099	Esplús	197	107	90	82	8	86	73	66	7	7	5	4	1	14	12	12	0	116	22	20	7	32
1989	22102	Estada	67	50	17	15	2	48	15	13	2	0	0	0	0	2	2	2	0	43	1	0	1	22
1989	22103	Estadilla	259	166	93	83	10	99	67	58	9	29	4	4	0	38	22	21	1	152	26	17	19	45
1989	22105	Estopiñán del Castillo	114	84	30	19	11	71	30	19	11	6	0	0	0	7	0	0	0	45	14	9	12	34
1989	22106	Fago	11	10	1	1	0	8	0	0	0	2	0	0	0	0	1	1	0	4	2	1	1	3
1989	22107	Fanlo	23	12	11	7	4	6	7	3	4	2	1	1	0	4	3	3	0	10	4	3	5	1
1989	22109	Fiscal	91	68	23	22	1	60	22	21	1	3	0	0	0	5	1	1	0	51	7	3	0	30
1989	22110	Fonz	258	154	104	51	53	133	87	42	45	8	0	0	0	13	17	9	8	109	19	18	8	104
1989	22111	Foradada del Toscar	99	84	15	11	4	44	11	8	3	18	2	2	0	22	2	1	1	48	13	5	3	30
1989	22112	Fraga	2110	1569	541	439	102	772	381	316	65	443	51	42	9	354	109	81	28	1002	196	36	16	860
1989	22113	Fueva (La)	314	225	89	71	18	152	74	57	17	47	3	2	1	26	12	12	0	142	65	47	34	26
1989	22114	Gistaín	105	88	17	11	6	55	11	8	3	23	0	0	0	10	6	3	3	49	12	6	4	34
1989	22115	Grado (El)	257	163	94	91	3	138	76	73	3	15	0	0	0	10	18	18	0	178	35	8	4	32
1989	22116	Grañén	333	233	100	93	7	178	75	70	5	27	2	2	0	28	23	21	2	104	67	5	136	21
1989	22117	Graus	622	475	147	135	12	337	114	107	7	80	13	12	1	58	20	16	4	406	52	25	4	135
1989	22119	Gurrea de Gállego	368	287	81	71	10	229	61	52	9	16	2	2	0	42	18	17	1	124	35	20	10	179
1989	22122	Hoz de Jaca	28	18	10	10	0	12	6	6	0	3	3	3	0	3	1	1	0	15	2	11	0	0
1989	22124	Huerto	110	87	23	21	2	66	20	18	2	9	1	1	0	12	2	2	0	42	28	23	10	7
1989	22125	Huesca	283	210	73	66	7	157	58	53	5	4	0	0	0	49	15	13	2	106	41	20	4	112
1989	22126	Ibieca	41	26	15	15	0	19	12	12	0	0	0	0	0	7	3	3	0	33	2	3	2	1
1989	22127	Igriés	35	28	7	6	1	18	7	6	1	0	0	0	0	10	0	0	0	13	2	2	0	18
1989	22128	Ilche	99	78	21	19	2	61	20	18	2	8	1	1	0	9	0	0	0	37	12	13	12	25
1989	22129	Isábena	102	81	21	16	5	49	10	7	3	23	0	0	0	9	11	9	2	65	15	2	0	20
1989	22130	Jaca	418	292	126	111	15	220	97	88	9	36	1	0	1	36	28	23	5	171	51	41	13	142
1989	22131	Jasa	22	16	6	6	0	11	2	2	0	3	1	1	0	2	3	3	0	5	6	2	2	7
1989	22133	Labuerda	47	35	12	11	1	33	12	11	1	1	0	0	0	1	0	0	0	33	5	1	8	0
1989	22135	Laluenga	103	87	16	11	5	69	9	5	4	2	0	0	0	16	7	6	1	46	6	20	14	17
1989	22136	Lalueza	400	308	92	81	11	235	70	59	11	46	4	4	0	27	18	18	0	209	12	5	1	173
1989	22137	Lanaja	355	263	92	85	7	218	72	66	6	29	1	1	0	16	19	18	1	204	8	5	2	136
1989	22139	Laperdiguera	31	25	6	6	0	20	4	4	0	0	1	1	0	5	1	1	0	13	2	6	4	6
1989	22141	Lascellas-Ponzano	55	32	23	19	4	30	21	19	2	1	0	0	0	1	2	0	2	31	6	9	3	6
1989	22142	Lascuarre	63	51	12	12	0	32	9	9	0	11	0	0	0	8	3	3	0	35	6	3	0	19
1989	22143	Laspaúles	98	87	11	10	1	52	10	9	1	20	0	0	0	15	1	1	0	10	32	3	0	53
1989	22144	Laspuña	92	54	38	32	6	28	34	29	5	22	0	0	0	4	4	3	1	57	25	6	4	0
1989	22149	Loarre	126	92	34	34	0	92	34	34	0	0	0	0	0	0	0	0	0	74	8	2	7	35
1989	22150	Loporzano	219	144	75	71	4	120	54	51	3	11	2	2	0	13	19	18	1	154	18	16	24	7
1989	22151	Loscorrales	49	39	10	7	3	37	10	7	3	0	0	0	0	2	0	0	0	23	4	3	3	16
1989	22155	Monesma y Cajigar	60	53	7	6	1	25	2	1	1	13	0	0	0	15	5	5	0	19	20	4	1	16
1989	22156	Monflorite-Lascasas	62	41	21	16	5	29	12	8	4	3	1	1	0	9	8	7	1	38	4	6	6	8
1989	22157	Montanuy	147	122	25	19	6	68	17	13	4	20	2	0	2	34	6	6	0	16	45	8	1	77
1989	22158	Monzón	956	625	331	300	31	520	286	265	21	41	6	6	0	64	39	29	10	612	79	25	11	229
1989	22160	Naval	103	84	19	19	0	69	16	16	0	6	0	0	0	9	3	3	0	67	13	6	2	15
1989	22162	Novales	40	32	8	8	0	29	8	8	0	0	0	0	0	3	0	0	0	16	4	15	1	4
1989	22163	Nueno	99	72	27	26	1	58	18	18	0	2	0	0	0	12	9	8	1	64	10	7	1	17
1989	22164	Olvena	36	24	12	12	0	19	9	9	0	4	0	0	0	1	3	3	0	20	7	1	3	5
1989	22165	Ontiñena	145	109	36	32	4	100	33	31	2	2	1	1	0	7	2	0	2	70	6	3	3	63
1989	22167	Osso de Cinca	293	239	54	36	18	115	24	15	9	50	4	3	1	74	26	18	8	103	33	39	13	105
1989	22168	Palo	32	21	11	10	1	21	11	10	1	0	0	0	0	0	0	0	0	26	4	1	1	0
1989	22170	Panticosa	72	52	20	19	1	40	19	18	1	5	0	0	0	7	1	1	0	43	12	2	5	10
1989	22172	Peñalba	138	95	43	36	7	77	35	30	5	2	0	0	0	16	8	6	2	72	14	23	6	23
1989	22173	Peñas de Riglos (Las)	88	57	31	30	1	57	31	30	1	0	0	0	0	0	0	0	0	63	10	0	2	13
1989	22174	Peralta de Alcofea	157	129	28	21	7	88	26	19	7	22	1	1	0	19	1	1	0	56	20	27	22	32
1989	22175	Peralta de Calasanz	278	222	56	50	6	174	45	41	4	34	4	4	0	14	7	5	2	163	30	22	22	41
1989	22176	Peraltilla	50	28	22	21	1	26	19	19	0	1	0	0	0	1	3	2	1	27	6	2	6	9
1989	22177	Perarrúa	81	52	29	23	6	34	22	18	4	11	1	1	0	7	6	4	2	59	5	4	1	12
1989	22178	Pertusa	34	27	7	5	2	18	7	5	2	1	0	0	0	8	0	0	0	12	4	7	8	3
1989	22181	Piracés	26	19	7	7	0	17	5	5	0	0	0	0	0	2	2	2	0	10	3	5	7	1
1989	22182	Plan	110	99	11	5	6	64	8	4	4	22	0	0	0	13	3	1	2	48	24	9	4	25
1989	22184	Poleñino	67	52	15	14	1	39	14	13	1	7	0	0	0	6	1	1	0	27	1	0	2	37
1989	22186	Pozán de Vero	105	76	29	26	3	70	20	18	2	3	0	0	0	3	9	8	1	21	42	22	4	16
1989	22187	Puebla de Castro (La)	114	78	36	30	6	59	34	28	6	15	0	0	0	4	2	2	0	90	8	3	2	11
1989	22188	Puente de Montañana	37	29	8	5	3	17	6	3	3	5	2	2	0	7	0	0	0	26	2	5	0	4
1989	22189	Puértolas	76	52	24	19	5	31	23	19	4	14	0	0	0	7	1	0	1	37	16	11	11	1
1989	22190	Pueyo de Araguás (El)	64	43	21	18	3	31	18	15	3	2	0	0	0	10	3	3	0	21	16	1	22	4
1989	22193	Pueyo de Santa Cruz	86	52	34	29	5	43	31	26	5	8	1	1	0	1	2	2	0	61	5	3	16	1
1989	22195	Quicena	13	9	4	4	0	6	3	3	0	1	0	0	0	2	1	1	0	8	0	2	2	1
1989	22197	Robres	145	111	34	28	6	91	25	22	3	6	0	0	0	14	9	6	3	52	12	4	2	75
1989	22199	Sabiñánigo	344	211	133	116	17	178	84	73	11	9	4	4	0	24	45	39	6	244	35	29	34	2
1989	22200	Sahún	77	62	15	13	2	39	13	12	1	17	0	0	0	6	2	1	1	22	21	7	14	13
1989	22201	Salas Altas	258	180	78	76	2	103	23	21	2	40	0	0	0	37	55	55	0	156	37	15	13	37
1989	22202	Salas Bajas	117	77	40	40	0	50	24	24	0	22	0	0	0	5	16	16	0	87	16	4	6	4
1989	22203	Salillas	40	31	9	9	0	23	8	8	0	5	0	0	0	3	1	1	0	17	13	6	3	1
1989	22204	Sallent de Gállego	115	67	48	41	7	50	32	29	3	14	5	4	1	3	11	8	3	66	27	8	5	9
1989	22205	San Esteban de Litera	363	254	109	98	11	172	88	80	8	47	8	7	1	35	13	11	2	222	22	13	24	82
1989	22206	Sangarrén	86	52	34	33	1	45	24	23	1	3	1	1	0	4	9	9	0	57	10	9	4	6
1989	22207	San Juan de Plan	64	61	3	3	0	31	1	1	0	20	1	1	0	10	1	1	0	7	16	14	8	19
1989	22208	Santa Cilia	61	46	15	15	0	32	11	11	0	10	0	0	0	4	4	4	0	21	14	2	1	23
1989	22209	Santa Cruz de la Serós	46	28	18	16	2	16	16	14	2	7	0	0	0	5	2	2	0	19	8	10	2	7
1989	22212	Santaliestra y San Quílez	32	23	9	8	1	18	7	6	1	4	1	1	0	1	1	1	0	22	2	1	0	7
1989	22213	Sariñena	656	475	181	136	45	313	162	124	38	65	2	2	0	97	17	10	7	242	79	71	76	188
1989	22214	Secastilla	83	57	26	23	3	36	19	16	3	11	2	2	0	10	5	5	0	65	6	2	1	9
1989	22215	Seira	41	36	5	4	1	24	4	3	1	7	0	0	0	5	1	1	0	16	11	4	5	5
1989	22217	Sena	156	130	26	20	6	116	25	19	6	9	0	0	0	5	1	1	0	50	31	3	0	72
1989	22218	Senés de Alcubierre	28	18	10	9	1	12	8	7	1	2	0	0	0	4	2	2	0	16	2	1	1	8
1989	22220	Sesa	69	56	13	11	2	43	13	11	2	6	0	0	0	7	0	0	0	20	15	22	6	6
1989	22221	Sesué	29	24	5	5	0	15	2	2	0	5	0	0	0	4	3	3	0	5	4	6	8	6
1989	22222	Siétamo	112	86	26	24	2	71	15	13	2	1	1	1	0	14	10	10	0	69	13	10	6	14
1989	22223	Sopeira	36	34	2	2	0	28	1	1	0	4	1	1	0	2	0	0	0	11	13	1	0	11
1989	22225	Tamarite de Litera	1190	839	351	303	48	366	195	157	38	208	24	22	2	265	132	124	8	618	194	72	31	275
1989	22226	Tardienta	237	129	108	105	3	115	97	96	1	4	0	0	0	10	11	9	2	167	20	6	9	35
1989	22227	Tella-Sin	74	54	20	20	0	35	14	14	0	15	0	0	0	4	6	6	0	41	12	8	7	6
1989	22228	Tierz	26	15	11	10	1	11	6	6	0	1	1	1	0	3	4	3	1	17	3	3	1	2
1989	22229	Tolva	105	80	25	22	3	49	20	18	2	18	0	0	0	13	5	4	1	62	13	12	0	18
1989	22230	Torla-Ordesa	73	66	7	4	3	43	6	4	2	12	0	0	0	11	1	0	1	18	7	1	0	47
1989	22232	Torralba de Aragón	52	36	16	12	4	27	15	11	4	2	0	0	0	7	1	1	0	20	6	2	3	21
1989	22233	Torre la Ribera	43	34	9	2	7	17	5	1	4	8	1	0	1	9	3	1	2	16	6	8	2	11
1989	22234	Torrente de Cinca	192	114	78	63	15	46	62	49	13	51	2	2	0	17	14	12	2	95	38	7	4	48
1989	22235	Torres de Alcanadre	37	29	8	7	1	25	4	4	0	2	0	0	0	2	4	3	1	12	9	4	4	8
1989	22236	Torres de Barbués	67	52	15	14	1	38	14	13	1	5	0	0	0	9	1	1	0	20	12	4	12	19
1989	22239	Tramaced	43	35	8	6	2	25	8	6	2	2	0	0	0	8	0	0	0	12	7	10	7	7
1989	22242	Valfarta	31	23	8	6	2	22	8	6	2	0	0	0	0	1	0	0	0	13	6	5	0	7
1989	22243	Valle de Bardají	23	19	4	3	1	11	3	2	1	5	0	0	0	3	1	1	0	9	0	0	0	14
1989	22244	Valle de Lierp	28	25	3	2	1	11	2	2	0	8	0	0	0	6	1	0	1	14	2	4	1	7
1989	22245	Velilla de Cinca	121	73	48	39	9	34	37	30	7	29	1	1	0	10	10	8	2	55	24	7	3	32
1989	22246	Beranuy	61	50	11	11	0	24	5	5	0	12	1	1	0	14	5	5	0	33	7	5	1	15
1989	22247	Viacamp y Litera	34	26	8	8	0	20	3	3	0	2	1	1	0	4	4	4	0	23	3	1	2	5
1989	22248	Vicién	16	11	5	5	0	5	3	3	0	1	0	0	0	5	2	2	0	8	4	3	1	0
1989	22249	Villanova	10	9	1	1	0	7	1	1	0	1	0	0	0	1	0	0	0	0	3	1	3	3
1989	22250	Villanúa	30	24	6	6	0	17	6	6	0	6	0	0	0	1	0	0	0	22	1	2	0	5
1989	22251	Villanueva de Sigena	116	73	43	29	14	61	39	25	14	8	1	1	0	4	3	3	0	23	20	27	29	17
1989	22252	Yebra de Basa	37	20	17	16	1	16	8	7	1	2	0	0	0	2	9	9	0	18	4	2	9	4
1989	22253	Yésero	36	26	10	10	0	13	5	5	0	9	0	0	0	4	5	5	0	25	3	2	1	5
1989	22254	Zaidín	632	524	108	94	14	276	72	61	11	135	10	9	1	113	26	24	2	232	92	33	9	266
1989	22901	Valle de Hecho	281	188	93	76	17	134	56	46	10	24	1	1	0	30	36	29	7	174	29	15	3	60
1989	22902	Puente la Reina de Jaca	99	74	25	23	2	45	23	21	2	16	0	0	0	13	2	2	0	29	15	7	17	31
1989	22903	San Miguel del Cinca	426	320	106	70	36	181	87	55	32	84	4	1	3	55	15	14	1	134	93	17	4	178
1989	22904	Sotonera (La)	483	277	206	204	2	244	157	155	2	11	2	2	0	22	47	47	0	396	17	3	0	67
1989	22905	Lupiñén-Ortilla	116	88	28	27	1	77	25	24	1	2	0	0	0	9	3	3	0	66	6	6	7	31
1989	22906	Santa María de Dulcis	90	65	25	17	8	59	21	14	7	3	0	0	0	3	4	3	1	29	22	20	15	4
1989	22907	Aínsa-Sobrarbe	191	139	52	44	8	117	42	35	7	12	3	2	1	10	7	7	0	99	13	5	3	71
1989	22908	Hoz y Costeán	218	150	68	67	1	127	39	38	1	14	2	2	0	9	27	27	0	166	11	12	12	17
1989	22909	Vencillón	128	101	27	22	5	65	17	15	2	13	0	0	0	23	10	7	3	39	11	8	11	59
1989	44001	Ababuj	52	45	7	4	3	25	4	2	2	11	1	1	0	9	2	1	1	18	13	7	5	9
1989	44002	Abejuela	25	23	2	2	0	19	1	1	0	4	1	1	0	0	0	0	0	17	3	0	0	5
1989	44003	Aguatón	18	17	1	1	0	10	1	1	0	7	0	0	0	0	0	0	0	7	2	1	0	8
1989	44004	Aguaviva	220	153	67	49	18	87	64	48	16	60	0	0	0	6	3	1	2	113	38	15	8	46
1989	44005	Aguilar del Alfambra	52	50	2	1	1	30	1	1	0	17	0	0	0	3	1	0	1	15	2	1	1	33
1989	44006	Alacón	200	176	24	17	7	101	12	9	3	63	1	0	1	12	11	8	3	115	19	9	10	47
1989	44007	Alba	107	91	16	16	0	52	16	16	0	17	0	0	0	22	0	0	0	35	8	18	2	44
1989	44008	Albalate del Arzobispo	518	231	287	246	41	129	230	195	35	83	25	25	0	19	32	26	6	308	88	20	17	85
1989	44009	Albarracín	103	76	27	23	4	61	18	16	2	4	1	1	0	11	8	6	2	65	9	7	1	21
1989	44010	Albentosa	181	124	57	53	4	108	50	47	3	12	3	2	1	4	4	4	0	151	6	4	7	13
1989	44011	Alcaine	34	13	21	21	0	10	19	19	0	2	1	1	0	1	1	1	0	24	2	0	0	8
1989	44012	Alcalá de la Selva	200	138	62	53	9	121	60	52	8	13	0	0	0	4	2	1	1	140	10	4	0	46
1989	44013	Alcañiz	1414	985	429	403	26	573	295	276	19	276	38	36	2	136	96	91	5	895	80	32	12	395
1989	44014	Alcorisa	729	473	256	253	3	304	180	177	3	117	15	15	0	52	61	61	0	584	53	11	46	35
1989	44016	Alfambra	220	187	33	29	4	129	30	26	4	46	0	0	0	12	3	3	0	124	32	14	20	30
1989	44017	Aliaga	177	150	27	26	1	127	26	25	1	17	0	0	0	6	1	1	0	119	7	9	0	42
1989	44018	Almohaja	6	6	0	0	0	5	0	0	0	1	0	0	0	0	0	0	0	2	0	1	0	3
1989	44019	Alobras	70	62	8	3	5	30	6	3	3	20	0	0	0	12	2	0	2	38	14	9	3	6
1989	44020	Alpeñés	20	18	2	0	2	18	2	0	2	0	0	0	0	0	0	0	0	5	2	4	5	4
1989	44021	Allepuz	121	106	15	15	0	80	14	14	0	11	0	0	0	15	1	1	0	59	0	0	2	60
1989	44022	Alloza	249	187	62	59	3	130	39	36	3	44	1	1	0	13	22	22	0	139	55	24	12	19
1989	44023	Allueva	2	2	0	0	0	2	0	0	0	0	0	0	0	0	0	0	0	0	0	0	0	2
1989	44024	Anadón	13	13	0	0	0	6	0	0	0	5	0	0	0	2	0	0	0	5	1	0	1	6
1989	44025	Andorra	588	379	209	207	2	176	136	134	2	151	15	15	0	52	58	58	0	467	47	18	19	37
1989	44026	Arcos de las Salinas	85	77	8	5	3	44	7	5	2	29	1	0	1	4	0	0	0	65	1	3	2	14
1989	44027	Arens de Lledó	148	121	27	24	3	72	17	14	3	31	3	3	0	18	7	7	0	63	32	5	17	31
1989	44028	Argente	119	114	5	5	0	66	4	4	0	29	0	0	0	19	1	1	0	55	8	6	40	10
1989	44029	Ariño	266	178	88	88	0	126	60	60	0	32	3	3	0	20	25	25	0	204	54	3	0	5
1989	44031	Azaila	57	31	26	8	18	27	23	6	17	2	1	1	0	2	2	1	1	11	7	9	17	13
1989	44032	Bádenas	10	8	2	2	0	7	1	1	0	1	1	1	0	0	0	0	0	3	1	0	0	6
1989	44033	Báguena	363	244	119	99	20	137	70	53	17	75	3	3	0	32	46	43	3	256	33	21	8	45
1989	44034	Bañón	69	64	5	5	0	36	4	4	0	17	0	0	0	11	1	1	0	20	7	3	21	18
1989	44035	Barrachina	79	65	14	9	5	35	11	7	4	23	3	2	1	7	0	0	0	44	6	10	1	18
1989	44036	Bea	13	6	7	5	2	5	7	5	2	0	0	0	0	1	0	0	0	7	3	2	0	1
1989	44037	Beceite	214	145	69	69	0	139	69	69	0	4	0	0	0	2	0	0	0	151	2	7	2	52
1989	44038	Belmonte de San José	157	135	22	20	2	94	18	17	1	36	0	0	0	5	4	3	1	79	47	5	9	17
1989	44039	Bello	203	200	3	3	0	91	3	3	0	70	0	0	0	39	0	0	0	112	27	29	9	26
1989	44040	Berge	131	69	62	58	4	41	43	40	3	18	8	8	0	10	11	10	1	79	24	8	8	12
1989	44041	Bezas	22	18	4	1	3	10	4	1	3	8	0	0	0	0	0	0	0	18	2	0	1	1
1989	44042	Blancas	75	70	5	4	1	45	3	3	0	19	0	0	0	6	2	1	1	31	12	12	3	17
1989	44043	Blesa	70	62	8	6	2	44	6	5	1	15	0	0	0	3	2	1	1	34	6	2	6	22
1989	44044	Bordón	69	63	6	3	3	41	4	1	3	16	1	1	0	6	1	1	0	24	12	5	5	23
1989	44045	Bronchales	75	45	30	25	5	43	30	25	5	1	0	0	0	1	0	0	0	36	14	1	5	19
1989	44046	Bueña	61	52	9	7	2	37	5	3	2	12	0	0	0	3	4	4	0	18	11	3	9	20
1989	44047	Burbáguena	391	241	150	144	6	169	72	67	5	29	6	6	0	43	72	71	1	334	21	9	4	23
1989	44048	Cabra de Mora	63	42	21	18	3	29	17	14	3	11	2	2	0	2	2	2	0	48	4	6	0	5
1989	44049	Calaceite	616	466	150	124	26	253	104	87	17	149	15	14	1	64	31	23	8	311	116	38	25	126
1989	44050	Calamocha	1109	874	235	209	26	649	179	157	22	170	6	5	1	55	50	47	3	780	65	71	28	165
1989	44051	Calanda	626	449	177	154	23	260	136	121	15	128	2	1	1	61	39	32	7	289	87	53	28	169
1989	44052	Calomarde	27	24	3	3	0	20	3	3	0	2	0	0	0	2	0	0	0	6	10	0	1	10
1989	44053	Camañas	69	65	4	3	1	42	2	1	1	13	0	0	0	10	2	2	0	21	7	11	3	27
1989	44054	Camarena de la Sierra	221	171	50	50	0	165	43	43	0	5	3	3	0	1	4	4	0	197	10	4	5	5
1989	44055	Camarillas	77	51	26	22	4	43	24	20	4	6	1	1	0	2	1	1	0	51	9	5	1	11
1989	44056	Caminreal	187	163	24	23	1	125	23	22	1	31	0	0	0	7	1	1	0	48	38	26	38	37
1989	44059	Cantavieja	176	142	34	27	7	70	30	26	4	40	1	1	0	32	3	0	3	66	20	18	7	65
1989	44060	Cañada de Benatanduz	50	43	7	2	5	21	5	2	3	10	0	0	0	12	2	0	2	14	7	9	6	14
1989	44061	Cañada de Verich (La)	93	72	21	20	1	44	17	16	1	19	0	0	0	9	4	4	0	57	25	1	4	6
1989	44062	Cañada Vellida	31	21	10	10	0	14	10	10	0	2	0	0	0	5	0	0	0	9	4	4	0	14
1989	44063	Cañizar del Olivar	70	49	21	21	0	41	17	17	0	5	0	0	0	3	4	4	0	62	2	4	0	2
1989	44064	Cascante del Río	245	175	70	70	0	157	55	55	0	11	3	3	0	7	12	12	0	209	16	5	6	9
1989	44065	Castejón de Tornos	62	55	7	6	1	24	4	3	1	24	0	0	0	7	3	3	0	35	8	10	2	7
1989	44066	Castel de Cabra	71	49	22	22	0	33	14	14	0	11	0	0	0	5	8	8	0	48	10	8	0	5
1989	44067	Castelnou	37	11	26	11	15	6	21	9	12	4	3	2	1	1	2	0	2	10	9	5	3	10
1989	44068	Castelserás	254	134	120	107	13	51	96	88	8	61	2	2	0	22	22	17	5	178	32	13	11	20
1989	44070	Castellar (El)	59	39	20	13	7	20	18	12	6	12	0	0	0	7	2	1	1	32	7	10	2	8
1989	44071	Castellote	552	401	151	140	11	287	100	95	5	71	10	10	0	43	41	35	6	369	69	46	10	58
1989	44074	Cedrillas	193	132	61	53	8	91	54	46	8	31	1	1	0	10	6	6	0	104	20	31	14	24
1989	44075	Celadas	222	198	24	18	6	106	15	10	5	61	1	1	0	31	8	7	1	98	31	45	3	45
1989	44076	Cella	911	660	251	238	13	317	184	176	8	235	11	10	1	108	56	52	4	501	134	125	65	86
1989	44077	Cerollera (La)	54	18	36	18	18	18	36	18	18	0	0	0	0	0	0	0	0	48	3	3	0	0
1989	44080	Codoñera (La)	130	111	19	15	4	59	11	8	3	36	3	3	0	16	5	4	1	37	27	17	1	48
1989	44082	Corbalán	54	47	7	7	0	26	7	7	0	16	0	0	0	5	0	0	0	31	4	8	1	10
1989	44084	Cortes de Aragón	32	24	8	8	0	14	6	6	0	9	0	0	0	1	2	2	0	16	6	0	3	7
1989	44085	Cosa	49	49	0	0	0	29	0	0	0	11	0	0	0	9	0	0	0	12	3	5	11	18
1989	44086	Cretas	412	324	88	79	9	204	60	54	6	80	6	5	1	40	22	20	2	96	168	23	15	110
1989	44087	Crivillén	100	83	17	17	0	80	17	17	0	2	0	0	0	1	0	0	0	91	1	0	2	6
1989	44088	Cuba (La)	37	35	2	2	0	22	1	1	0	10	0	0	0	3	1	1	0	17	5	3	0	12
1989	44089	Cubla	145	124	21	21	0	110	17	17	0	9	0	0	0	5	4	4	0	115	12	4	9	5
1989	44090	Cucalón	17	16	1	1	0	12	1	1	0	3	0	0	0	1	0	0	0	3	2	0	1	11
1989	44092	Cuervo (El)	88	69	19	11	8	41	12	8	4	21	2	2	0	7	5	1	4	63	20	4	0	1
1989	44093	Cuevas de Almudén	41	19	22	21	1	15	14	14	0	1	0	0	0	3	8	7	1	29	8	0	0	4
1989	44094	Cuevas Labradas	68	60	8	6	2	39	7	6	1	18	0	0	0	3	1	0	1	34	12	4	9	9
1989	44096	Ejulve	364	278	86	86	0	241	70	70	0	18	3	3	0	19	13	13	0	327	13	12	2	10
1989	44097	Escorihuela	143	133	10	8	2	61	7	5	2	53	0	0	0	19	3	3	0	89	15	9	0	30
1989	44099	Escucha	110	85	25	24	1	69	16	15	1	4	0	0	0	12	9	9	0	79	7	13	0	11
1989	44100	Estercuel	133	114	19	19	0	109	18	18	0	2	0	0	0	3	1	1	0	129	1	3	0	0
1989	44101	Ferreruela de Huerva	30	29	1	1	0	25	1	1	0	2	0	0	0	2	0	0	0	9	1	14	2	4
1989	44102	Fonfría	21	21	0	0	0	11	0	0	0	7	0	0	0	3	0	0	0	5	4	0	0	12
1989	44103	Formiche Alto	74	56	18	13	5	33	16	12	4	22	2	1	1	1	0	0	0	61	5	3	2	3
1989	44105	Fórnoles	299	200	99	95	4	153	65	62	3	29	8	7	1	18	26	26	0	253	18	6	4	18
1989	44106	Fortanete	141	90	51	46	5	54	46	41	5	22	2	2	0	14	3	3	0	73	13	18	12	25
1989	44107	Foz-Calanda	122	103	19	16	3	51	12	12	0	25	1	0	1	27	6	4	2	38	20	14	6	44
1989	44108	Fresneda (La)	447	334	113	111	2	220	89	88	1	77	8	8	0	37	16	15	1	304	44	19	2	78
1989	44109	Frías de Albarracín	47	36	11	9	2	23	11	9	2	5	0	0	0	8	0	0	0	11	13	0	1	22
1989	44110	Fuenferrada	29	22	7	6	1	20	7	6	1	2	0	0	0	0	0	0	0	9	1	9	2	8
1989	44111	Fuentes Calientes	73	62	11	10	1	37	6	5	1	16	0	0	0	9	5	5	0	35	7	5	8	18
1989	44112	Fuentes Claras	208	171	37	32	5	120	33	28	5	39	1	1	0	12	3	3	0	106	10	9	6	77
1989	44113	Fuentes de Rubielos	85	61	24	10	14	56	22	10	12	1	1	0	1	4	1	0	1	69	8	4	2	2
1989	44114	Fuentespalda	209	178	31	26	5	120	29	24	5	46	1	1	0	12	1	1	0	88	29	10	12	70
1989	44115	Galve	77	58	19	13	6	29	11	9	2	20	0	0	0	9	8	4	4	39	5	12	4	17
1989	44116	Gargallo	101	79	22	22	0	76	19	19	0	2	0	0	0	1	3	3	0	97	1	3	0	0
1989	44117	Gea de Albarracín	156	112	44	36	8	89	36	29	7	15	1	0	1	8	7	7	0	89	20	9	6	32
1989	44118	Ginebrosa (La)	232	200	32	32	0	128	29	29	0	52	0	0	0	20	3	3	0	88	44	9	24	67
1989	44119	Griegos	37	25	12	8	4	21	11	7	4	2	1	1	0	2	0	0	0	7	8	2	2	18
1989	44120	Guadalaviar	65	53	12	7	5	38	11	6	5	6	0	0	0	9	1	1	0	9	17	1	2	36
1989	44121	Gúdar	77	55	22	18	4	39	15	12	3	11	2	2	0	5	5	4	1	50	8	5	2	12
1989	44122	Híjar	449	323	126	114	12	250	114	103	11	55	2	2	0	18	10	9	1	182	107	60	13	87
1989	44123	Hinojosa de Jarque	62	31	31	29	2	24	27	25	2	4	0	0	0	3	4	4	0	40	7	5	3	7
1989	44124	Hoz de la Vieja (La)	99	56	43	43	0	44	43	43	0	11	0	0	0	1	0	0	0	68	2	4	1	24
1989	44125	Huesa del Común	51	41	10	9	1	38	10	9	1	1	0	0	0	2	0	0	0	30	6	5	2	8
1989	44126	Iglesuela del Cid (La)	171	140	31	29	2	95	31	29	2	39	0	0	0	6	0	0	0	87	4	1	37	42
1989	44127	Jabaloyas	58	53	5	2	3	31	2	2	0	18	1	0	1	4	2	0	2	30	5	3	6	14
1989	44128	Jarque de la Val	44	27	17	13	4	14	10	7	3	4	2	1	1	9	5	5	0	21	10	1	4	8
1989	44129	Jatiel	11	4	7	3	4	2	7	3	4	2	0	0	0	0	0	0	0	4	3	1	0	3
1989	44130	Jorcas	32	29	3	3	0	18	2	2	0	7	0	0	0	4	1	1	0	8	1	1	2	20
1989	44131	Josa	59	20	39	39	0	19	39	39	0	0	0	0	0	1	0	0	0	54	1	0	0	4
1989	44132	Lagueruela	28	28	0	0	0	22	0	0	0	5	0	0	0	1	0	0	0	6	2	7	0	13
1989	44133	Lanzuela	19	16	3	3	0	13	3	3	0	2	0	0	0	1	0	0	0	9	2	1	1	6
1989	44135	Libros	177	121	56	49	7	94	38	31	7	18	5	5	0	9	13	13	0	148	6	4	7	12
1989	44136	Lidón	36	35	1	1	0	23	0	0	0	9	0	0	0	3	1	1	0	10	4	2	7	13
1989	44137	Linares de Mora	184	135	49	42	7	82	37	35	2	32	3	2	1	21	9	5	4	117	21	12	1	33
1989	44138	Loscos	69	63	6	4	2	50	4	4	0	11	0	0	0	2	2	0	2	27	4	4	2	32
1989	44141	Lledó	104	91	13	11	2	53	8	6	2	23	1	1	0	15	4	4	0	30	28	7	9	30
1989	44142	Maicas	32	7	25	24	1	7	25	24	1	0	0	0	0	0	0	0	0	30	0	0	0	2
1989	44143	Manzanera	258	182	76	72	4	145	58	55	3	32	3	3	0	5	15	14	1	191	27	9	5	26
1989	44144	Martín del Río	123	85	38	35	3	77	32	29	3	4	0	0	0	4	6	6	0	86	10	11	1	15
1989	44145	Mas de las Matas	186	152	34	20	14	107	33	19	14	37	0	0	0	8	1	1	0	86	22	12	10	56
1989	44146	Mata de los Olmos (La)	54	32	22	22	0	29	20	20	0	3	0	0	0	0	2	2	0	49	4	0	0	1
1989	44147	Mazaleón	402	356	46	38	8	197	23	19	4	82	7	6	1	77	16	13	3	101	105	19	164	13
1989	44148	Mezquita de Jarque	43	32	11	10	1	21	6	5	1	6	0	0	0	5	5	5	0	19	8	3	2	11
1989	44149	Mirambel	62	50	12	11	1	28	11	10	1	14	1	1	0	8	0	0	0	20	7	5	4	26
1989	44150	Miravete de la Sierra	53	48	5	5	0	36	5	5	0	7	0	0	0	5	0	0	0	34	0	1	2	16
1989	44151	Molinos	162	79	83	74	9	33	74	66	8	35	4	4	0	11	5	4	1	101	17	14	7	23
1989	44152	Monforte de Moyuela	43	37	6	4	2	30	5	3	2	7	0	0	0	0	1	1	0	14	3	2	1	23
1989	44153	Monreal del Campo	376	320	56	53	3	230	48	46	2	71	2	1	1	19	6	6	0	192	53	54	37	40
1989	44154	Monroyo	141	28	113	47	66	26	99	42	57	0	5	1	4	2	9	4	5	102	21	12	5	1
1989	44155	Montalbán	163	131	32	32	0	114	24	24	0	12	1	1	0	5	7	7	0	143	11	1	2	6
1989	44156	Monteagudo del Castillo	41	36	5	4	1	29	5	4	1	6	0	0	0	1	0	0	0	17	1	0	0	23
1989	44157	Monterde de Albarracín	29	27	2	2	0	17	1	1	0	7	0	0	0	3	1	1	0	9	4	2	0	14
1989	44158	Mora de Rubielos	330	235	95	89	6	220	90	84	6	8	0	0	0	7	5	5	0	256	13	7	2	52
1989	44159	Moscardón	32	27	5	1	4	11	4	0	4	7	1	1	0	9	0	0	0	13	15	3	1	0
1989	44160	Mosqueruela	332	282	50	43	7	182	40	38	2	82	2	2	0	18	8	3	5	132	3	0	74	123
1989	44161	Muniesa	253	198	55	52	3	112	37	34	3	69	0	0	0	17	18	18	0	149	23	9	10	62
1989	44163	Noguera de Albarracín	50	35	15	13	2	31	13	12	1	2	0	0	0	2	2	1	1	29	4	2	1	14
1989	44164	Nogueras	14	13	1	1	0	11	1	1	0	1	0	0	0	1	0	0	0	5	2	2	1	4
1989	44165	Nogueruelas	138	72	66	28	38	67	53	24	29	3	7	3	4	2	6	1	5	109	17	4	5	3
1989	44167	Obón	99	21	78	78	0	10	77	77	0	7	0	0	0	4	1	1	0	89	3	1	0	6
1989	44168	Odón	115	106	9	8	1	71	9	8	1	25	0	0	0	10	0	0	0	49	10	5	4	47
1989	44169	Ojos Negros	125	105	20	17	3	74	16	14	2	22	0	0	0	9	4	3	1	64	12	9	4	36
1989	44171	Olba	320	291	29	24	5	277	28	23	5	13	0	0	0	1	1	1	0	299	9	2	5	5
1989	44172	Oliete	354	265	89	87	2	191	65	63	2	52	3	3	0	22	21	21	0	269	39	16	1	29
1989	44173	Olmos (Los)	106	76	30	30	0	55	15	15	0	14	0	0	0	7	15	15	0	68	14	4	9	11
1989	44174	Orihuela del Tremedal	44	22	22	19	3	21	20	17	3	0	1	1	0	1	1	1	0	12	13	0	2	17
1989	44175	Orrios	91	78	13	5	8	53	8	4	4	22	1	0	1	3	4	1	3	52	7	5	12	15
1989	44176	Palomar de Arroyos	59	43	16	14	2	41	12	10	2	1	0	0	0	1	4	4	0	38	10	6	0	5
1989	44177	Pancrudo	81	62	19	14	5	61	19	14	5	1	0	0	0	0	0	0	0	36	10	17	7	11
1989	44178	Parras de Castellote (Las)	58	51	7	6	1	33	7	6	1	14	0	0	0	4	0	0	0	31	4	2	3	18
1989	44179	Peñarroya de Tastavins	285	253	32	30	2	152	26	24	2	75	3	3	0	26	3	3	0	121	50	10	17	87
1989	44180	Peracense	29	24	5	5	0	13	4	4	0	6	0	0	0	5	1	1	0	18	1	1	1	8
1989	44181	Peralejos	38	35	3	3	0	23	3	3	0	12	0	0	0	0	0	0	0	23	6	1	6	2
1989	44182	Perales del Alfambra	137	96	41	34	7	64	35	30	5	18	1	1	0	14	5	3	2	73	8	11	14	31
1989	44183	Pitarque	113	82	31	28	3	68	29	27	2	9	1	1	0	5	1	0	1	87	8	7	2	9
1989	44184	Plou	21	8	13	13	0	5	13	13	0	3	0	0	0	0	0	0	0	15	1	0	0	5
1989	44185	Pobo (El)	90	70	20	14	6	41	16	10	6	17	2	2	0	12	2	2	0	37	11	19	10	13
1989	44187	Portellada (La)	122	115	7	5	2	65	5	3	2	33	0	0	0	17	2	2	0	31	28	7	0	56
1989	44189	Pozondón	43	31	12	8	4	23	11	7	4	4	1	1	0	4	0	0	0	25	7	6	0	5
1989	44190	Pozuel del Campo	36	33	3	3	0	20	2	2	0	10	0	0	0	3	1	1	0	14	6	1	2	13
1989	44191	Puebla de Híjar (La)	163	87	76	42	34	65	66	36	30	20	0	0	0	2	10	6	4	47	33	14	20	49
1989	44192	Puebla de Valverde (La)	312	234	78	68	10	213	71	65	6	10	7	3	4	11	0	0	0	252	9	8	4	39
1989	44193	Puertomingalvo	146	125	21	21	0	78	19	19	0	35	0	0	0	12	2	2	0	71	6	3	23	43
1989	44194	Ráfales	102	92	10	10	0	66	6	6	0	20	1	1	0	6	3	3	0	33	23	5	1	40
1989	44195	Rillo	40	35	5	3	2	27	3	2	1	1	0	0	0	7	2	1	1	10	0	3	2	25
1989	44196	Riodeva	328	239	89	81	8	198	80	73	7	36	1	1	0	5	8	7	1	305	11	5	1	6
1989	44197	Ródenas	50	37	13	11	2	29	9	7	2	7	1	1	0	1	3	3	0	31	3	4	5	7
1989	44198	Royuela	47	41	6	3	3	38	6	3	3	2	0	0	0	1	0	0	0	10	5	0	4	28
1989	44199	Rubiales	52	31	21	21	0	28	21	21	0	2	0	0	0	1	0	0	0	46	3	0	1	2
1989	44200	Rubielos de la Cérida	27	27	0	0	0	17	0	0	0	3	0	0	0	7	0	0	0	12	0	0	2	13
1989	44201	Rubielos de Mora	293	110	183	167	16	92	179	165	14	12	2	1	1	6	2	1	1	246	10	6	0	31
1989	44203	Salcedillo	6	4	2	2	0	2	2	2	0	2	0	0	0	0	0	0	0	1	2	1	0	2
1989	44204	Saldón	36	25	11	5	6	16	3	2	1	9	2	2	0	0	6	1	5	31	1	1	3	0
1989	44205	Samper de Calanda	263	202	61	55	6	157	53	47	6	33	2	2	0	12	6	6	0	148	15	25	15	60
1989	44206	San Agustín	222	150	72	63	9	123	62	55	7	23	2	2	0	4	8	6	2	167	23	13	6	13
1989	44207	San Martín del Río	264	186	78	66	12	115	69	59	10	66	1	1	0	5	8	6	2	186	39	21	11	7
1989	44208	Santa Cruz de Nogueras	15	13	2	2	0	10	2	2	0	1	0	0	0	2	0	0	0	6	1	2	1	5
1989	44209	Santa Eulalia	182	144	38	36	2	91	36	34	2	31	0	0	0	22	2	2	0	94	17	12	5	54
1989	44210	Sarrión	298	185	113	103	10	174	99	89	10	5	4	4	0	6	10	10	0	237	6	12	3	40
1989	44211	Segura de los Baños	23	11	12	11	1	8	12	11	1	2	0	0	0	1	0	0	0	11	6	1	2	3
1989	44212	Seno	59	44	15	13	2	34	15	13	2	6	0	0	0	4	0	0	0	39	6	4	2	8
1989	44213	Singra	55	51	4	4	0	27	1	1	0	13	0	0	0	11	3	3	0	22	8	8	0	17
1989	44215	Terriente	100	75	25	15	10	40	15	7	8	29	2	2	0	6	8	6	2	59	14	11	6	10
1989	44216	Teruel	666	475	191	165	26	318	158	137	21	132	8	7	1	25	25	21	4	390	62	74	60	80
1989	44217	Toril y Masegoso	23	20	3	2	1	9	1	1	0	7	0	0	0	4	2	1	1	15	2	2	4	0
1989	44218	Tormón	23	11	12	7	5	5	7	4	3	6	3	2	1	0	2	1	1	16	5	2	0	0
1989	44219	Tornos	122	102	20	14	6	54	19	13	6	41	1	1	0	7	0	0	0	72	18	16	2	14
1989	44220	Torralba de los Sisones	112	104	8	8	0	53	7	7	0	41	0	0	0	10	1	1	0	54	18	12	4	24
1989	44221	Torrecilla de Alcañiz	180	125	55	47	8	50	40	32	8	54	9	9	0	21	6	6	0	61	22	36	17	44
1989	44222	Torrecilla del Rebollar	59	54	5	3	2	36	2	1	1	17	1	1	0	1	2	1	1	6	10	11	0	32
1989	44223	Torre de Arcas	30	6	24	19	5	6	22	18	4	0	1	0	1	0	1	1	0	10	17	2	1	0
1989	44224	Torre de las Arcas	29	26	3	3	0	19	3	3	0	3	0	0	0	4	0	0	0	20	3	2	1	3
1989	44225	Torre del Compte	188	127	61	59	2	76	39	37	2	36	7	7	0	15	15	15	0	122	20	17	3	26
1989	44226	Torrelacárcel	106	93	13	12	1	62	9	8	1	23	0	0	0	8	4	4	0	46	4	14	4	38
1989	44227	Torre los Negros	53	50	3	3	0	35	3	3	0	11	0	0	0	4	0	0	0	33	7	5	3	5
1989	44228	Torremocha de Jiloca	70	64	6	6	0	41	5	5	0	15	0	0	0	8	1	1	0	30	6	13	3	18
1989	44229	Torres de Albarracín	40	23	17	15	2	21	15	13	2	2	0	0	0	0	2	2	0	10	16	2	0	12
1989	44230	Torrevelilla	156	73	83	73	10	36	56	53	3	28	10	7	3	9	17	13	4	101	25	10	6	14
1989	44231	Torrijas	59	54	5	5	0	30	3	3	0	20	0	0	0	4	2	2	0	46	3	2	0	8
1989	44232	Torrijo del Campo	246	216	30	26	4	118	22	19	3	85	3	2	1	13	5	5	0	76	54	39	17	60
1989	44234	Tramacastiel	184	137	47	42	5	127	42	40	2	8	1	1	0	2	4	1	3	156	8	7	6	7
1989	44235	Tramacastilla	27	19	8	5	3	12	8	5	3	2	0	0	0	5	0	0	0	6	4	0	0	17
1989	44236	Tronchón	66	47	19	16	3	31	15	14	1	9	2	2	0	7	2	0	2	36	5	8	8	9
1989	44237	Urrea de Gaén	173	114	59	54	5	86	53	48	5	25	0	0	0	3	6	6	0	66	37	33	1	36
1989	44238	Utrillas	82	57	25	25	0	48	18	18	0	3	0	0	0	6	7	7	0	66	4	5	0	7
1989	44239	Valacloche	73	60	13	13	0	57	8	8	0	3	0	0	0	0	5	5	0	65	4	1	1	2
1989	44240	Valbona	130	87	43	39	4	60	33	30	3	25	3	3	0	2	7	6	1	107	6	5	2	10
1989	44241	Valdealgorfa	392	220	172	153	19	101	104	89	15	88	21	21	0	31	47	43	4	259	34	32	12	55
1989	44243	Valdecuenca	10	6	4	3	1	3	2	1	1	3	0	0	0	0	2	2	0	6	1	3	0	0
1989	44244	Valdelinares	79	72	7	5	2	47	6	5	1	12	0	0	0	13	1	0	1	29	3	1	10	36
1989	44245	Valdeltormo	66	54	12	9	3	24	8	6	2	17	1	1	0	13	3	2	1	23	19	4	10	10
1989	44246	Valderrobres	627	446	181	155	26	294	90	72	18	106	16	13	3	46	75	70	5	324	74	54	15	160
1989	44247	Valjunquera	250	193	57	45	12	92	29	20	9	66	8	7	1	35	20	18	2	106	48	31	11	54
1989	44249	Vallecillo (El)	12	11	1	1	0	7	1	1	0	2	0	0	0	2	0	0	0	9	0	1	0	2
1989	44250	Veguillas de la Sierra	14	11	3	2	1	8	3	2	1	2	0	0	0	1	0	0	0	1	1	1	6	5
1989	44251	Villafranca del Campo	131	99	32	24	8	68	25	18	7	21	2	1	1	10	5	5	0	73	11	17	3	27
1989	44252	Villahermosa del Campo	25	23	2	2	0	21	2	2	0	1	0	0	0	1	0	0	0	6	4	4	2	9
1989	44256	Villanueva del Rebollar de la Sierra	19	18	1	1	0	11	0	0	0	7	1	1	0	0	0	0	0	0	1	4	0	14
1989	44257	Villar del Cobo	65	56	9	4	5	46	8	3	5	7	1	1	0	3	0	0	0	17	6	2	4	36
1989	44258	Villar del Salz	52	46	6	6	0	39	4	4	0	3	0	0	0	4	2	2	0	41	1	3	0	7
1989	44260	Villarluengo	146	116	30	27	3	61	24	21	3	26	5	5	0	29	1	1	0	69	10	17	13	37
1989	44261	Villarquemado	364	296	68	55	13	190	34	28	6	47	4	4	0	59	30	23	7	147	17	11	1	188
1989	44262	Villarroya de los Pinares	87	69	18	15	3	51	17	14	3	10	1	1	0	8	0	0	0	54	3	0	2	28
1989	44263	Villastar	111	86	25	24	1	50	10	10	0	33	2	2	0	3	13	12	1	87	4	8	1	11
1989	44264	Villel	545	305	240	240	0	250	151	151	0	41	29	29	0	14	60	60	0	494	31	6	4	10
1989	44265	Vinaceite	102	86	16	10	6	71	15	9	6	11	0	0	0	4	1	1	0	27	7	4	4	60
1989	44266	Visiedo	94	84	10	10	0	48	8	8	0	27	0	0	0	9	2	2	0	43	7	6	24	14
1989	44267	Vivel del Río Martín	38	27	11	7	4	19	10	6	4	8	0	0	0	0	1	1	0	5	8	12	1	12
1989	44268	Zoma (La)	30	22	8	8	0	19	7	7	0	1	0	0	0	2	1	1	0	27	0	2	0	1
1989	50001	Abanto	44	42	2	1	1	41	2	1	1	0	0	0	0	1	0	0	0	6	9	12	12	5
1989	50002	Acered	243	240	3	2	1	126	1	1	0	71	1	1	0	43	1	0	1	93	86	41	12	11
1989	50003	Agón	96	33	63	54	9	15	35	31	4	9	3	1	2	9	25	22	3	51	21	10	2	12
1989	50004	Aguarón	328	63	265	151	114	54	240	136	104	5	18	10	8	4	7	5	2	239	38	29	10	12
1989	50005	Aguilón	154	115	39	37	2	94	27	26	1	7	1	1	0	14	11	10	1	113	10	4	5	22
1989	50006	Ainzón	455	266	189	160	29	196	124	108	16	28	4	4	0	42	61	48	13	324	53	22	15	41
1989	50007	Aladrén	113	55	58	58	0	51	44	44	0	3	4	4	0	1	10	10	0	106	3	0	2	2
1989	50008	Alagón	830	479	351	346	5	452	313	308	5	11	6	6	0	16	32	32	0	633	86	34	15	62
1989	50009	Alarba	192	120	72	56	16	49	36	25	11	31	0	0	0	40	36	31	5	135	10	8	13	26
1989	50010	Alberite de San Juan	25	11	14	9	5	10	8	5	3	1	0	0	0	0	6	4	2	11	3	3	2	6
1989	50011	Albeta	4	1	3	3	0	1	3	3	0	0	0	0	0	0	0	0	0	3	0	0	1	0
1989	50012	Alborge	11	2	9	8	1	2	8	7	1	0	0	0	0	0	1	1	0	5	4	0	1	1
1989	50013	Alcalá de Ebro	125	77	48	48	0	68	43	43	0	6	2	2	0	3	3	3	0	86	15	15	6	3
1989	50014	Alcalá de Moncayo	62	40	22	18	4	27	18	14	4	8	0	0	0	5	4	4	0	38	7	4	5	8
1989	50015	Alconchel de Ariza	107	86	21	15	6	47	18	13	5	19	0	0	0	20	3	2	1	54	13	18	7	15
1989	50016	Aldehuela de Liestos	17	13	4	4	0	13	3	3	0	0	0	0	0	0	1	1	0	5	0	5	3	4
1989	50017	Alfajarín	294	144	150	141	9	115	117	108	9	4	2	2	0	25	31	31	0	199	20	10	3	62
1989	50018	Alfamén	571	252	319	289	30	195	160	140	20	13	6	6	0	44	153	143	10	369	108	28	36	30
1989	50019	Alforque	53	47	6	6	0	31	5	5	0	12	1	1	0	4	0	0	0	36	4	1	1	11
1989	50020	Alhama de Aragón	117	78	39	38	1	76	38	37	1	0	0	0	0	2	1	1	0	85	15	6	2	9
1989	50021	Almochuel	18	18	0	0	0	12	0	0	0	4	0	0	0	2	0	0	0	4	2	0	1	11
1989	50022	Almolda (La)	268	156	112	99	13	138	81	71	10	1	2	1	1	17	29	27	2	206	32	9	7	14
1989	50023	Almonacid de la Cuba	212	135	77	71	6	57	40	37	3	67	7	7	0	11	30	27	3	136	21	10	27	18
1989	50024	Almonacid de la Sierra	445	230	215	166	49	193	161	125	36	21	9	8	1	16	45	33	12	286	64	39	22	34
1989	50025	Almunia de Doña Godina (La)	1473	734	739	697	42	433	402	370	32	144	58	57	1	157	279	270	9	1221	90	49	17	96
1989	50026	Alpartir	395	289	106	104	2	181	58	57	1	36	9	9	0	72	39	38	1	294	50	36	8	7
1989	50027	Ambel	266	157	109	108	1	126	57	56	1	16	4	4	0	15	48	48	0	225	13	7	6	15
1989	50028	Anento	21	12	9	9	0	10	7	7	0	2	0	0	0	0	2	2	0	12	6	1	1	1
1989	50029	Aniñón	448	412	36	33	3	287	32	29	3	92	2	2	0	33	2	2	0	286	63	73	17	9
1989	50030	Añón de Moncayo	135	91	44	38	6	67	33	29	4	15	0	0	0	9	11	9	2	100	13	8	3	11
1989	50031	Aranda de Moncayo	104	68	36	32	4	66	28	24	4	1	0	0	0	1	8	8	0	75	7	5	5	12
1989	50032	Arándiga	260	111	149	143	6	90	130	129	1	15	11	6	5	6	8	8	0	175	12	22	37	14
1989	50033	Ardisa	54	31	23	23	0	25	11	11	0	3	0	0	0	3	12	12	0	44	1	1	3	5
1989	50034	Ariza	269	202	67	61	6	196	60	54	6	1	1	1	0	5	6	6	0	199	12	10	22	26
1989	50035	Artieda	13	8	5	5	0	7	4	4	0	0	0	0	0	1	1	1	0	7	2	2	0	2
1989	50036	Asín	24	19	5	5	0	18	5	5	0	0	0	0	0	1	0	0	0	19	2	2	1	0
1989	50037	Atea	317	171	146	110	36	72	112	93	19	70	8	6	2	29	26	11	15	154	96	35	17	15
1989	50038	Ateca	686	313	373	360	13	249	185	176	9	30	26	24	2	34	162	160	2	626	27	4	8	21
1989	50039	Azuara	238	82	156	137	19	71	138	121	17	3	5	4	1	8	13	12	1	144	23	31	5	35
1989	50040	Badules	34	27	7	7	0	21	7	7	0	0	0	0	0	6	0	0	0	11	7	6	4	6
1989	50041	Bagüés	30	18	12	12	0	16	11	11	0	1	0	0	0	1	1	1	0	26	1	0	1	2
1989	50042	Balconchán	27	23	4	4	0	19	3	3	0	4	0	0	0	0	1	1	0	21	1	2	3	0
1989	50043	Bárboles	77	46	31	31	0	40	29	29	0	4	0	0	0	2	2	2	0	52	9	5	9	2
1989	50044	Bardallur	100	23	77	12	65	4	72	10	62	16	2	1	1	3	3	1	2	61	15	10	3	11
1989	50045	Belchite	535	258	277	165	112	239	260	149	111	17	11	10	1	2	6	6	0	323	92	26	7	87
1989	50046	Belmonte de Gracián	182	143	39	28	11	90	30	21	9	28	1	0	1	25	8	7	1	100	26	20	7	29
1989	50047	Berdejo	21	20	1	1	0	14	1	1	0	4	0	0	0	2	0	0	0	19	1	0	0	1
1989	50048	Berrueco	13	10	3	1	2	9	3	1	2	1	0	0	0	0	0	0	0	3	1	4	3	2
1989	50050	Bijuesca	101	70	31	22	9	61	20	16	4	5	0	0	0	4	11	6	5	42	19	18	9	13
1989	50051	Biota	399	306	93	72	21	253	66	54	12	9	2	1	1	44	25	17	8	268	36	39	32	24
1989	50052	Bisimbre	57	40	17	10	7	23	13	6	7	8	0	0	0	9	4	4	0	36	2	2	16	1
1989	50053	Boquiñeni	435	292	143	112	31	177	93	76	17	72	10	8	2	43	40	28	12	322	26	16	11	60
1989	50054	Bordalba	29	28	1	1	0	28	1	1	0	0	0	0	0	0	0	0	0	2	1	13	6	7
1989	50055	Borja	752	343	409	356	53	228	348	300	48	85	10	8	2	30	51	48	3	496	100	37	38	81
1989	50056	Botorrita	34	26	8	6	2	24	8	6	2	0	0	0	0	2	0	0	0	13	4	4	7	6
1989	50057	Brea de Aragón	253	114	139	138	1	68	88	87	1	31	5	5	0	15	46	46	0	234	12	0	3	4
1989	50058	Bubierca	53	37	16	16	0	37	15	15	0	0	0	0	0	0	1	1	0	42	3	4	1	3
1989	50059	Bujaraloz	228	141	87	76	11	121	74	65	9	1	0	0	0	19	13	11	2	124	35	37	25	7
1989	50060	Bulbuente	260	184	76	71	5	161	67	63	4	11	2	1	1	12	7	7	0	212	20	10	5	13
1989	50061	Bureta	101	81	20	17	3	60	17	14	3	12	0	0	0	9	3	3	0	49	10	7	9	26
1989	50062	Burgo de Ebro (El)	354	194	160	158	2	175	147	145	2	4	0	0	0	15	13	13	0	287	21	6	1	39
1989	50063	Buste (El)	42	32	10	2	8	14	7	0	7	12	0	0	0	6	3	2	1	15	12	7	4	4
1989	50064	Cabañas de Ebro	151	82	69	69	0	64	54	54	0	11	1	1	0	7	14	14	0	105	30	13	3	0
1989	50065	Cabolafuente	33	31	2	2	0	31	2	2	0	0	0	0	0	0	0	0	0	11	3	7	3	9
1989	50066	Cadrete	76	57	19	19	0	49	15	15	0	2	0	0	0	6	4	4	0	55	3	0	14	4
1989	50067	Calatayud	965	612	353	326	27	464	248	224	24	42	8	7	1	106	97	95	2	593	203	46	29	94
1989	50068	Calatorao	991	490	501	455	46	351	321	286	35	85	31	30	1	54	149	139	10	820	63	47	18	43
1989	50069	Calcena	49	39	10	10	0	37	10	10	0	1	0	0	0	1	0	0	0	44	1	1	0	3
1989	50070	Calmarza	29	22	7	5	2	21	7	5	2	0	0	0	0	1	0	0	0	11	3	7	5	3
1989	50071	Campillo de Aragón	85	39	46	37	9	33	41	32	9	2	0	0	0	4	5	5	0	55	8	14	1	7
1989	50072	Carenas	145	106	39	32	7	88	25	21	4	8	2	2	0	10	12	9	3	67	29	18	18	13
1989	50073	Cariñena	1005	517	488	444	44	328	309	275	34	66	12	11	1	123	167	158	9	861	68	29	13	34
1989	50074	Caspe	1510	963	547	491	56	712	445	404	41	148	20	15	5	103	82	72	10	863	223	60	7	357
1989	50075	Castejón de Alarba	98	90	8	4	4	53	6	4	2	27	0	0	0	10	2	0	2	14	30	36	18	0
1989	50076	Castejón de las Armas	90	62	28	14	14	58	26	12	14	4	0	0	0	0	2	2	0	57	15	5	4	9
1989	50077	Castejón de Valdejasa	204	122	82	78	4	89	64	61	3	12	3	3	0	21	15	14	1	142	20	21	6	15
1989	50078	Castiliscar	149	106	43	39	4	100	43	39	4	6	0	0	0	0	0	0	0	120	5	4	10	10
1989	50079	Cervera de la Cañada	194	163	31	28	3	137	27	25	2	20	1	1	0	6	3	2	1	96	43	20	14	21
1989	50080	Cerveruela	2	2	0	0	0	2	0	0	0	0	0	0	0	0	0	0	0	0	0	0	0	2
1989	50081	Cetina	240	163	77	75	2	144	59	57	2	13	4	4	0	6	14	14	0	160	19	4	2	55
1989	50082	Cimballa	47	25	22	19	3	20	18	15	3	5	1	1	0	0	3	3	0	26	10	5	3	3
1989	50083	Cinco Olivas	7	1	6	5	1	1	5	4	1	0	0	0	0	0	1	1	0	0	5	1	0	1
1989	50084	Clarés de Ribota	96	71	25	24	1	59	25	24	1	10	0	0	0	2	0	0	0	59	18	6	7	6
1989	50085	Codo	22	13	9	3	6	13	8	2	6	0	1	1	0	0	0	0	0	10	1	1	0	10
1989	50086	Codos	360	241	119	118	1	160	85	84	1	59	6	6	0	22	28	28	0	259	37	21	19	24
1989	50087	Contamina	29	25	4	3	1	25	4	3	1	0	0	0	0	0	0	0	0	18	5	4	0	2
1989	50088	Cosuenda	407	221	186	177	9	138	105	100	5	41	4	3	1	42	77	74	3	300	64	12	12	19
1989	50089	Cuarte de Huerva	30	25	5	5	0	21	4	4	0	2	0	0	0	2	1	1	0	20	1	1	8	0
1989	50090	Cubel	62	59	3	3	0	47	1	1	0	1	1	1	0	11	1	1	0	12	7	22	13	8
1989	50091	Cuerlas (Las)	27	25	2	2	0	22	1	1	0	1	0	0	0	2	1	1	0	7	0	6	11	3
1989	50092	Chiprana	58	33	25	25	0	16	20	20	0	13	1	1	0	4	4	4	0	50	2	0	0	6
1989	50093	Chodes	117	58	59	58	1	53	37	37	0	2	1	1	0	3	21	20	1	79	19	3	2	14
1989	50094	Daroca	262	116	146	145	1	110	128	127	1	3	2	2	0	3	16	16	0	216	5	2	0	39
1989	50095	Ejea de los Caballeros	4647	2941	1706	1434	272	2195	889	791	98	184	33	27	6	562	784	616	168	3493	424	322	215	193
1989	50096	Embid de Ariza	23	22	1	1	0	22	1	1	0	0	0	0	0	0	0	0	0	12	1	3	0	7
1989	50098	Encinacorba	217	159	58	56	2	127	44	43	1	14	1	1	0	18	13	12	1	167	21	13	10	6
1989	50099	Épila	1244	671	573	533	40	501	278	243	35	87	12	12	0	83	283	278	5	928	59	42	17	198
1989	50100	Erla	60	45	15	14	1	38	9	8	1	4	1	1	0	3	5	5	0	45	4	3	1	7
1989	50101	Escatrón	470	303	167	158	9	165	113	105	8	90	15	15	0	48	39	38	1	426	23	5	1	15
1989	50102	Fabara	552	433	119	109	10	209	87	81	6	145	9	9	0	79	23	19	4	177	107	39	7	222
1989	50104	Farlete	142	94	48	43	5	79	32	28	4	0	0	0	0	15	16	15	1	91	6	0	9	36
1989	50105	Fayón	125	94	31	28	3	71	22	20	2	19	1	0	1	4	8	8	0	47	39	21	11	7
1989	50106	Fayos (Los)	86	57	29	28	1	52	23	22	1	2	0	0	0	3	6	6	0	77	3	3	0	3
1989	50107	Figueruelas	124	78	46	46	0	72	38	38	0	3	1	1	0	3	7	7	0	94	8	7	5	10
1989	50108	Fombuena	7	6	1	1	0	5	0	0	0	0	0	0	0	1	1	1	0	2	1	1	2	1
1989	50109	Frago (El)	45	29	16	15	1	22	12	11	1	5	2	2	0	2	2	2	0	36	2	2	0	5
1989	50110	Frasno (El)	601	355	246	205	41	225	134	109	25	77	22	22	0	53	90	74	16	405	107	50	10	29
1989	50111	Fréscano	101	79	22	10	12	49	14	9	5	14	2	0	2	16	6	1	5	54	7	11	27	2
1989	50113	Fuendejalón	338	235	103	93	10	186	59	49	10	20	4	4	0	29	40	40	0	201	34	31	26	46
1989	50114	Fuendetodos	56	28	28	25	3	24	26	23	3	0	0	0	0	4	2	2	0	25	13	4	1	13
1989	50115	Fuentes de Ebro	658	309	349	338	11	265	321	310	11	15	0	0	0	29	28	28	0	385	106	14	24	129
1989	50116	Fuentes de Jiloca	205	118	87	63	24	95	46	31	15	9	2	1	1	14	39	31	8	145	12	25	7	16
1989	50117	Gallocanta	51	39	12	7	5	34	5	1	4	0	5	5	0	5	2	1	1	10	9	18	7	7
1989	50118	Gallur	610	340	270	247	23	267	220	202	18	40	3	2	1	33	47	43	4	485	47	33	19	26
1989	50119	Gelsa	419	317	102	91	11	209	74	63	11	86	3	3	0	22	25	25	0	228	55	21	6	109
1989	50120	Godojos	62	48	14	13	1	47	13	12	1	1	0	0	0	0	1	1	0	33	11	12	2	4
1989	50121	Gotor	157	68	89	86	3	34	62	59	3	25	9	9	0	9	18	18	0	132	17	6	0	2
1989	50122	Grisel	51	32	19	18	1	23	15	14	1	2	3	3	0	7	1	1	0	38	2	1	2	8
1989	50123	Grisén	84	38	46	46	0	37	43	43	0	0	0	0	0	1	3	3	0	66	10	6	1	1
1989	50124	Herrera de los Navarros	267	138	129	124	5	107	122	118	4	22	1	1	0	9	6	5	1	162	13	15	3	74
1989	50125	Ibdes	296	200	96	89	7	163	58	52	6	17	2	2	0	20	36	35	1	204	55	30	4	3
1989	50126	Illueca	394	170	224	221	3	140	135	132	3	16	4	4	0	14	85	85	0	371	11	6	3	3
1989	50128	Isuerre	39	29	10	8	2	24	5	4	1	0	0	0	0	5	5	4	1	32	1	3	1	2
1989	50129	Jaraba	90	40	50	50	0	32	39	39	0	8	2	2	0	0	9	9	0	75	6	3	0	6
1989	50130	Jarque de Moncayo	334	185	149	139	10	96	85	75	10	75	13	13	0	14	51	51	0	281	41	2	2	8
1989	50131	Jaulín	80	57	23	23	0	42	15	15	0	3	0	0	0	12	8	8	0	46	0	5	26	3
1989	50132	Joyosa (La)	89	61	28	28	0	52	19	19	0	1	0	0	0	8	9	9	0	54	5	8	2	20
1989	50133	Lagata	49	28	21	9	12	26	17	7	10	0	1	0	1	2	3	2	1	19	8	0	2	20
1989	50134	Langa del Castillo	39	36	3	1	2	31	2	0	2	5	0	0	0	0	1	1	0	6	3	1	0	29
1989	50135	Layana	7	5	2	2	0	4	1	1	0	0	1	1	0	1	0	0	0	5	0	0	0	2
1989	50136	Lécera	224	152	72	63	9	140	50	41	9	6	0	0	0	6	22	22	0	135	25	18	17	29
1989	50137	Leciñena	290	177	113	104	9	147	75	66	9	6	4	4	0	24	34	34	0	152	19	13	2	104
1989	50138	Lechón	22	22	0	0	0	14	0	0	0	3	0	0	0	5	0	0	0	2	4	7	5	4
1989	50139	Letux	141	71	70	23	47	55	59	19	40	12	4	0	4	4	7	4	3	77	12	0	6	46
1989	50140	Litago	89	49	40	11	29	31	27	7	20	12	0	0	0	6	13	4	9	56	17	9	3	4
1989	50141	Lituénigo	92	52	40	14	26	26	22	7	15	24	2	0	2	2	16	7	9	44	24	21	1	2
1989	50142	Lobera de Onsella	77	61	16	15	1	53	14	14	0	2	0	0	0	6	2	1	1	68	3	2	4	0
1989	50143	Longares	579	376	203	171	32	214	92	75	17	54	10	10	0	108	101	86	15	420	53	31	8	67
1989	50144	Longás	59	43	16	15	1	40	15	14	1	0	0	0	0	3	1	1	0	52	2	0	3	2
1989	50146	Lucena de Jalón	143	89	54	53	1	58	22	21	1	11	1	1	0	20	31	31	0	117	8	6	2	10
1989	50147	Luceni	215	136	79	75	4	126	73	71	2	3	0	0	0	7	6	4	2	145	8	5	4	53
1989	50148	Luesia	137	97	40	32	8	74	27	20	7	14	4	3	1	9	9	9	0	89	12	8	5	23
1989	50149	Luesma	21	17	4	4	0	12	3	3	0	2	0	0	0	3	1	1	0	13	1	4	0	3
1989	50150	Lumpiaque	161	128	33	29	4	99	20	18	2	17	3	3	0	12	10	8	2	106	5	26	4	20
1989	50151	Luna	623	452	171	133	38	418	159	123	36	3	0	0	0	31	12	10	2	494	17	26	19	67
1989	50152	Maella	1025	759	266	234	32	437	185	168	17	212	22	20	2	110	59	46	13	573	145	115	75	117
1989	50153	Magallón	554	266	288	238	50	132	147	105	42	67	6	3	3	67	135	130	5	381	67	32	18	56
1989	50154	Mainar	33	31	2	2	0	28	2	2	0	1	0	0	0	2	0	0	0	9	0	1	0	23
1989	50155	Malanquilla	51	38	13	12	1	37	13	12	1	1	0	0	0	0	0	0	0	28	9	4	5	5
1989	50156	Maleján	0	0	0	0	0	0	0	0	0	0	0	0	0	0	0	0	0	0	0	0	0	0
1989	50157	Malón	140	90	50	48	2	74	31	29	2	8	2	2	0	8	17	17	0	118	10	4	1	7
1989	50159	Maluenda	392	292	100	94	6	237	80	74	6	17	3	3	0	38	17	17	0	185	77	49	43	38
1989	50160	Mallén	584	389	195	119	76	281	154	100	54	54	9	2	7	54	32	17	15	404	44	21	110	5
1989	50161	Manchones	66	57	9	6	3	43	7	5	2	12	0	0	0	2	2	1	1	31	11	8	8	8
1989	50162	Mara	216	163	53	51	2	109	39	38	1	44	4	4	0	10	10	9	1	155	28	7	11	15
1989	50163	María de Huerva	161	121	40	39	1	85	30	30	0	8	0	0	0	28	10	9	1	100	2	3	42	14
1989	50164	Mediana de Aragón	186	129	57	50	7	102	51	45	6	6	1	1	0	21	5	4	1	83	32	4	28	39
1989	50165	Mequinenza	801	381	420	414	6	157	267	262	5	159	30	30	0	65	123	122	1	558	134	17	9	83
1989	50166	Mesones de Isuela	197	145	52	51	1	89	32	31	1	29	4	4	0	27	16	16	0	64	45	11	8	69
1989	50167	Mezalocha	152	107	45	30	15	45	28	17	11	39	2	1	1	23	15	12	3	65	25	11	10	41
1989	50168	Mianos	17	14	3	3	0	10	2	2	0	0	1	1	0	4	0	0	0	10	1	3	2	1
1989	50169	Miedes de Aragón	269	194	75	52	23	125	47	28	19	43	4	3	1	26	24	21	3	122	45	18	23	61
1989	50170	Monegrillo	194	126	68	60	8	91	49	42	7	0	2	2	0	35	17	16	1	126	6	9	6	47
1989	50171	Moneva	56	27	29	29	0	21	25	25	0	4	0	0	0	2	4	4	0	27	16	2	2	9
1989	50172	Monreal de Ariza	124	101	23	16	7	62	15	8	7	23	0	0	0	16	8	8	0	30	14	26	11	43
1989	50173	Monterde	36	32	4	2	2	32	4	2	2	0	0	0	0	0	0	0	0	5	8	8	5	10
1989	50174	Montón	113	65	48	39	9	37	26	18	8	16	1	1	0	12	21	20	1	83	7	7	3	13
1989	50175	Morata de Jalón	634	309	325	301	24	258	259	241	18	37	19	17	2	14	47	43	4	504	69	21	21	19
1989	50176	Morata de Jiloca	174	137	37	18	19	77	26	14	12	38	5	4	1	22	6	0	6	44	50	20	19	41
1989	50177	Morés	377	217	160	154	6	135	83	78	5	25	11	11	0	57	66	65	1	299	34	11	0	33
1989	50178	Moros	355	254	101	84	17	220	83	68	15	3	0	0	0	31	18	16	2	156	52	29	14	104
1989	50179	Moyuela	133	97	36	25	11	63	23	15	8	23	2	2	0	11	11	8	3	53	22	13	19	26
1989	50180	Mozota	53	25	28	23	5	23	26	21	5	1	0	0	0	1	2	2	0	34	3	0	1	15
1989	50181	Muel	219	142	77	74	3	127	69	66	3	8	0	0	0	7	8	8	0	139	15	17	3	45
1989	50182	Muela (La)	195	144	51	50	1	110	39	38	1	8	2	2	0	26	10	10	0	125	2	5	26	37
1989	50183	Munébrega	317	177	140	116	24	118	77	59	18	39	6	3	3	20	57	54	3	245	37	13	11	11
1989	50184	Murero	64	46	18	8	10	33	12	6	6	8	0	0	0	5	6	2	4	31	13	7	4	9
1989	50185	Murillo de Gállego	88	67	21	21	0	62	19	19	0	2	0	0	0	3	2	2	0	76	1	1	1	9
1989	50186	Navardún	39	31	8	7	1	24	5	5	0	0	0	0	0	7	3	2	1	24	2	4	1	8
1989	50187	Nigüella	62	47	15	15	0	38	10	10	0	0	1	1	0	9	4	4	0	29	8	9	13	3
1989	50188	Nombrevilla	12	8	4	4	0	7	3	3	0	0	1	1	0	1	0	0	0	5	2	0	0	5
1989	50189	Nonaspe	437	325	112	97	15	190	66	56	10	75	5	4	1	60	41	37	4	296	48	26	12	55
1989	50190	Novallas	207	143	64	60	4	137	48	45	3	2	4	3	1	4	12	12	0	155	14	14	4	20
1989	50191	Novillas	404	275	129	81	48	190	90	63	27	37	14	3	11	48	25	15	10	275	22	35	72	0
1989	50192	Nuévalos	15	7	8	8	0	6	8	8	0	0	0	0	0	1	0	0	0	9	0	2	2	2
1989	50193	Nuez de Ebro	73	39	34	34	0	39	34	34	0	0	0	0	0	0	0	0	0	67	4	1	0	1
1989	50194	Olvés	209	118	91	71	20	51	43	27	16	42	10	10	0	25	38	34	4	129	32	16	12	20
1989	50195	Orcajo	23	19	4	4	0	13	2	2	0	5	2	2	0	1	0	0	0	12	1	0	7	3
1989	50196	Orera	130	74	56	51	5	55	35	32	3	15	1	1	0	4	20	18	2	82	21	13	5	9
1989	50197	Orés	50	43	7	4	3	43	5	4	1	0	1	0	1	0	1	0	1	33	5	1	1	10
1989	50198	Oseja	92	50	42	41	1	14	34	33	1	35	5	5	0	1	3	3	0	90	2	0	0	0
1989	50199	Osera de Ebro	74	42	32	31	1	39	31	30	1	2	0	0	0	1	1	1	0	59	5	4	0	6
1989	50200	Paniza	629	359	270	233	37	246	151	141	10	58	9	8	1	55	110	84	26	543	47	10	19	10
1989	50201	Paracuellos de Jiloca	277	276	1	1	0	189	1	1	0	13	0	0	0	74	0	0	0	227	18	17	11	4
1989	50202	Paracuellos de la Ribera	328	235	93	86	7	152	48	41	7	60	15	15	0	23	30	30	0	238	37	6	11	36
1989	50203	Pastriz	206	79	127	124	3	78	113	110	3	0	0	0	0	1	14	14	0	191	7	3	2	3
1989	50204	Pedrola	485	238	247	238	9	156	206	197	9	47	7	7	0	35	34	34	0	350	46	32	19	38
1989	50205	Pedrosas (Las)	39	29	10	10	0	25	8	8	0	0	2	2	0	4	0	0	0	23	2	5	7	2
1989	50206	Perdiguera	157	92	65	49	16	57	37	27	10	10	0	0	0	25	28	22	6	86	21	12	5	33
1989	50207	Piedratajada	101	71	30	25	5	69	28	23	5	0	0	0	0	2	2	2	0	77	2	9	4	9
1989	50208	Pina de Ebro	591	369	222	215	7	340	213	206	7	9	1	1	0	20	8	8	0	457	36	15	4	79
1989	50209	Pinseque	212	119	93	92	1	114	91	90	1	0	0	0	0	5	2	2	0	157	21	32	0	2
1989	50210	Pintanos (Los)	68	52	16	15	1	47	16	15	1	2	0	0	0	3	0	0	0	48	0	4	3	13
1989	50211	Plasencia de Jalón	138	60	78	74	4	55	75	74	1	0	0	0	0	5	3	0	3	81	7	2	24	24
1989	50212	Pleitas	29	23	6	6	0	16	5	5	0	1	0	0	0	6	1	1	0	16	5	2	5	1
1989	50213	Plenas	90	55	35	21	14	28	27	17	10	19	2	1	1	8	6	3	3	44	20	11	5	10
1989	50214	Pomer	47	31	16	15	1	30	16	15	1	1	0	0	0	0	0	0	0	45	1	0	1	0
1989	50215	Pozuel de Ariza	18	16	2	1	1	7	1	0	1	5	0	0	0	4	1	1	0	4	2	8	2	2
1989	50216	Pozuelo de Aragón	142	102	40	26	14	54	24	15	9	13	0	0	0	35	16	11	5	64	14	8	13	43
1989	50217	Pradilla de Ebro	222	139	83	72	11	85	38	31	7	35	4	4	0	19	41	37	4	133	30	19	23	17
1989	50218	Puebla de Albortón	61	32	29	14	15	31	28	13	15	0	0	0	0	1	1	1	0	26	5	3	2	25
1989	50219	Puebla de Alfindén (La)	130	68	62	51	11	63	56	47	9	1	0	0	0	4	6	4	2	83	14	15	8	10
1989	50220	Puendeluna	38	28	10	10	0	19	8	8	0	3	0	0	0	6	2	2	0	27	5	2	1	3
1989	50221	Purujosa	3	3	0	0	0	1	0	0	0	1	0	0	0	1	0	0	0	1	0	0	0	2
1989	50222	Quinto	386	221	165	152	13	192	132	121	11	3	2	2	0	26	31	29	2	220	33	13	0	120
1989	50223	Remolinos	153	107	46	46	0	78	29	29	0	16	0	0	0	13	17	17	0	93	12	13	13	22
1989	50224	Retascón	52	30	22	22	0	24	18	18	0	2	1	1	0	4	3	3	0	32	1	0	0	19
1989	50225	Ricla	1157	630	527	438	89	357	286	240	46	126	37	28	9	147	204	170	34	917	91	39	43	67
1989	50227	Romanos	55	47	8	8	0	32	6	6	0	3	0	0	0	12	2	2	0	22	11	9	2	11
1989	50228	Rueda de Jalón	261	141	120	114	6	102	99	94	5	4	2	1	1	35	19	19	0	134	14	23	69	21
1989	50229	Ruesca	69	46	23	15	8	25	15	8	7	11	2	2	0	10	6	5	1	39	14	5	4	7
1989	50230	Sádaba	327	255	72	56	16	231	62	47	15	1	0	0	0	23	10	9	1	200	27	54	28	18
1989	50231	Salillas de Jalón	70	38	32	24	8	33	23	17	6	2	0	0	0	3	9	7	2	54	7	2	4	3
1989	50232	Salvatierra de Esca	62	42	20	17	3	34	18	16	2	2	0	0	0	6	2	1	1	44	3	2	5	8
1989	50233	Samper del Salz	26	16	10	8	2	13	9	7	2	3	1	1	0	0	0	0	0	18	0	0	1	7
1989	50234	San Martín de la Virgen de Moncayo	40	28	12	8	4	18	9	7	2	9	0	0	0	1	3	1	2	22	9	7	0	2
1989	50235	San Mateo de Gállego	311	210	101	96	5	175	70	65	5	18	0	0	0	17	31	31	0	114	104	6	1	86
1989	50236	Santa Cruz de Grío	261	165	96	74	22	114	68	55	13	23	7	7	0	28	21	12	9	134	83	31	7	6
1989	50237	Santa Cruz de Moncayo	56	37	19	19	0	30	12	12	0	5	1	1	0	2	6	6	0	50	4	0	1	1
1989	50238	Santa Eulalia de Gállego	57	39	18	17	1	39	17	16	1	0	1	1	0	0	0	0	0	49	3	0	3	2
1989	50239	Santed	25	19	6	5	1	18	3	2	1	1	0	0	0	0	3	3	0	5	7	6	4	3
1989	50240	Sástago	281	106	175	155	20	98	163	145	18	4	6	5	1	4	6	5	1	78	81	13	13	96
1989	50241	Saviñán	426	215	211	185	26	142	115	93	22	38	8	8	0	35	88	84	4	376	20	6	17	7
1989	50242	Sediles	102	67	35	33	2	38	26	25	1	24	4	3	1	5	5	5	0	80	7	7	2	6
1989	50243	Sestrica	537	256	281	271	10	171	121	114	7	61	15	15	0	24	145	142	3	465	41	13	2	16
1989	50244	Sierra de Luna	112	77	35	28	7	68	26	21	5	3	4	4	0	6	5	3	2	68	9	5	23	7
1989	50245	Sigüés	72	51	21	19	2	40	13	11	2	4	1	1	0	7	7	7	0	58	2	5	2	5
1989	50246	Sisamón	23	22	1	1	0	21	1	1	0	0	0	0	0	1	0	0	0	7	0	7	2	7
1989	50247	Sobradiel	148	88	60	59	1	74	43	42	1	3	1	1	0	11	16	16	0	96	21	9	3	19
1989	50248	Sos del Rey Católico	279	201	78	68	10	162	55	45	10	6	0	0	0	33	23	23	0	167	31	36	15	30
1989	50249	Tabuenca	303	220	83	80	3	130	64	63	1	59	3	3	0	31	16	14	2	115	71	20	21	76
1989	50250	Talamantes	33	29	4	3	1	23	4	3	1	4	0	0	0	2	0	0	0	26	1	2	1	3
1989	50251	Tarazona	1584	966	618	588	30	775	443	415	28	100	15	14	1	91	160	159	1	1040	249	77	69	149
1989	50252	Tauste	1770	1079	691	594	97	782	392	340	52	95	12	11	1	202	287	243	44	1125	168	150	67	260
1989	50253	Terrer	284	137	147	143	4	53	127	123	4	83	18	18	0	1	2	2	0	235	7	4	0	38
1989	50254	Tierga	206	87	119	115	4	56	79	76	3	9	7	7	0	22	33	32	1	110	41	13	12	30
1989	50255	Tobed	170	118	52	46	6	69	40	35	5	30	1	1	0	19	11	10	1	111	24	10	12	13
1989	50256	Torralba de los Frailes	43	41	2	1	1	36	1	0	1	2	0	0	0	3	1	1	0	4	5	14	9	11
1989	50257	Torralba de Ribota	117	108	9	8	1	86	8	8	0	21	0	0	0	1	1	0	1	55	32	14	8	8
1989	50258	Torralbilla	25	24	1	1	0	22	1	1	0	0	0	0	0	2	0	0	0	8	2	0	0	15
1989	50259	Torrehermosa	49	43	6	2	4	26	3	2	1	11	0	0	0	6	3	0	3	3	5	16	11	14
1989	50260	Torrelapaja	16	16	0	0	0	10	0	0	0	6	0	0	0	0	0	0	0	6	4	3	0	3
1989	50261	Torrellas	48	38	10	10	0	29	6	6	0	2	0	0	0	7	4	4	0	38	3	2	1	4
1989	50262	Torres de Berrellén	418	266	152	147	5	218	120	116	4	23	7	7	0	25	25	24	1	313	51	17	6	31
1989	50263	Torrijo de la Cañada	431	251	180	138	42	211	70	44	26	28	11	10	1	12	99	84	15	290	57	22	24	38
1989	50264	Tosos	271	143	128	116	12	85	90	83	7	48	7	6	1	10	31	27	4	203	38	10	5	15
1989	50265	Trasmoz	69	52	17	6	11	29	10	4	6	16	0	0	0	7	7	2	5	28	21	9	6	5
1989	50266	Trasobares	134	104	30	28	2	82	24	22	2	12	0	0	0	10	6	6	0	68	17	6	4	39
1989	50267	Uncastillo	447	310	137	129	8	284	115	111	4	5	3	3	0	21	19	15	4	359	26	21	8	33
1989	50268	Undués de Lerda	43	33	10	9	1	33	10	9	1	0	0	0	0	0	0	0	0	35	0	6	1	1
1989	50269	Urrea de Jalón	164	80	84	83	1	57	53	52	1	19	3	3	0	4	28	28	0	103	14	12	33	2
1989	50270	Urriés	35	27	8	7	1	24	8	7	1	1	0	0	0	2	0	0	0	28	2	1	1	3
1989	50271	Used	114	96	18	15	3	78	15	12	3	9	1	1	0	9	2	2	0	34	10	29	20	21
1989	50272	Utebo	280	123	157	156	1	107	157	156	1	5	0	0	0	11	0	0	0	143	33	5	26	73
1989	50273	Valdehorna	46	41	5	5	0	29	5	5	0	11	0	0	0	1	0	0	0	14	13	4	11	4
1989	50274	Val de San Martín	39	33	6	6	0	18	6	6	0	12	0	0	0	3	0	0	0	18	4	2	8	7
1989	50275	Valmadrid	37	17	20	10	10	16	20	10	10	0	0	0	0	1	0	0	0	24	2	1	0	10
1989	50276	Valpalmas	88	51	37	37	0	32	29	29	0	10	1	1	0	9	7	7	0	65	4	3	5	11
1989	50277	Valtorres	47	43	4	2	2	32	4	2	2	11	0	0	0	0	0	0	0	19	8	9	8	3
1989	50278	Velilla de Ebro	101	80	21	20	1	51	14	13	1	20	1	1	0	9	6	6	0	61	9	6	2	23
1989	50279	Velilla de Jiloca	96	55	41	36	5	30	25	21	4	14	2	2	0	11	14	13	1	68	8	4	3	13
1989	50280	Vera de Moncayo	160	118	42	38	4	99	31	29	2	14	2	1	1	5	9	8	1	94	17	6	5	38
1989	50281	Vierlas	39	32	7	7	0	20	3	3	0	10	0	0	0	2	4	4	0	28	5	1	2	3
1989	50282	Vilueña (La)	87	53	34	30	4	33	15	13	2	12	2	2	0	8	17	15	2	65	10	7	2	3
1989	50283	Villadoz	36	30	6	3	3	23	6	3	3	5	0	0	0	2	0	0	0	13	0	1	0	22
1989	50284	Villafeliche	148	94	54	50	4	60	38	34	4	19	1	1	0	15	15	15	0	115	9	6	9	9
1989	50285	Villafranca de Ebro	158	77	81	78	3	70	74	71	3	2	0	0	0	5	7	7	0	117	18	6	10	7
1989	50286	Villalba de Perejil	67	40	27	25	2	32	26	24	2	6	1	1	0	2	0	0	0	51	7	1	1	7
1989	50287	Villalengua	230	193	37	28	9	123	22	16	6	34	1	1	0	36	14	11	3	86	35	29	36	44
1989	50288	Villanueva de Gállego	485	244	241	228	13	211	192	181	11	5	2	2	0	28	47	45	2	392	29	17	3	44
1989	50289	Villanueva de Jiloca	67	38	29	23	6	25	27	21	6	13	0	0	0	0	2	2	0	40	20	4	3	0
1989	50290	Villanueva de Huerva	428	176	252	235	17	74	179	165	14	73	11	11	0	29	62	59	3	323	49	10	17	29
1989	50291	Villar de los Navarros	84	59	25	20	5	42	20	17	3	10	0	0	0	7	5	3	2	32	20	7	9	16
1989	50292	Villarreal de Huerva	29	20	9	6	3	16	6	4	2	3	1	1	0	1	2	1	1	9	4	0	0	16
1989	50293	Villarroya de la Sierra	610	453	157	127	30	258	93	66	27	111	6	6	0	84	58	55	3	436	66	50	9	49
1989	50294	Villarroya del Campo	29	27	2	1	1	26	1	1	0	0	0	0	0	1	1	0	1	7	0	0	0	22
1989	50295	Vistabella	154	5	149	149	0	4	117	117	0	0	5	5	0	1	27	27	0	151	1	1	0	1
1989	50296	Zaida (La)	67	24	43	42	1	16	42	41	1	5	0	0	0	3	1	1	0	41	12	3	0	11
1989	50297	Zaragoza	3154	2068	1086	990	96	1555	704	628	76	250	47	45	2	263	335	317	18	1896	367	168	128	595
1989	50298	Zuera	769	418	351	336	15	384	297	284	13	10	19	19	0	24	35	33	2	473	50	31	22	193
1989	50901	Biel	53	36	17	14	3	31	17	14	3	4	0	0	0	1	0	0	0	43	4	3	0	3
1999	22001	Abiego	85	52	33	23	10	41	27	17	10	6	0	0	0	5	6	6	0	38	18	9	11	9
1999	22002	Abizanda	49	30	19	13	6	17	12	7	5	7	2	1	1	6	5	5	0	24	8	2	4	11
1999	22003	Adahuesca	60	38	22	17	5	28	17	13	4	7	1	1	0	3	4	3	1	31	18	5	5	1
1999	22004	Agüero	78	53	25	24	1	45	15	14	1	3	3	3	0	5	7	7	0	60	8	4	3	3
1999	22006	Aísa	40	27	13	11	2	17	8	6	2	3	2	2	0	7	3	3	0	15	7	5	1	11
1999	22007	Albalate de Cinca	287	180	107	83	24	134	73	52	21	22	11	9	2	24	23	22	1	151	33	26	27	36
1999	22008	Albalatillo	29	15	14	10	4	13	9	5	4	0	3	3	0	2	2	2	0	15	5	5	3	1
1999	22009	Albelda	486	379	107	89	18	214	56	48	8	78	14	11	3	87	37	30	7	181	90	40	40	134
1999	22011	Albero Alto	29	23	6	5	1	19	4	3	1	0	0	0	0	4	2	2	0	18	1	2	3	5
1999	22012	Albero Bajo	62	39	23	21	2	31	17	15	2	1	2	2	0	7	4	4	0	31	5	3	5	17
1999	22013	Alberuela de Tubo	71	39	32	24	8	28	22	16	6	8	2	2	0	3	8	6	2	35	14	2	7	12
1999	22014	Alcalá de Gurrea	60	37	23	18	5	28	12	9	3	2	1	1	0	7	10	8	2	27	7	8	9	6
1999	22015	Alcalá del Obispo	121	79	42	35	7	65	25	18	7	7	5	5	0	7	12	12	0	70	12	7	13	15
1999	22016	Alcampell	431	282	149	86	63	148	83	50	33	72	19	8	11	62	47	28	19	263	79	27	36	26
1999	22017	Alcolea de Cinca	244	169	75	68	7	142	54	48	6	18	7	6	1	9	14	14	0	159	21	31	7	25
1999	22018	Alcubierre	130	103	27	21	6	92	18	13	5	5	0	0	0	6	9	8	1	63	7	8	20	27
1999	22019	Alerre	16	9	7	7	0	8	4	4	0	0	0	0	0	1	3	3	0	12	0	1	1	2
1999	22020	Alfántega	58	33	25	21	4	17	11	8	3	6	2	2	0	10	12	11	1	30	13	1	4	10
1999	22021	Almudévar	639	416	223	210	13	309	133	123	10	34	20	20	0	73	70	67	3	386	83	51	31	81
1999	22022	Almunia de San Juan	182	109	73	66	7	80	50	44	6	15	7	7	0	14	16	15	1	127	22	8	13	12
1999	22023	Almuniente	165	94	71	65	6	75	45	39	6	6	6	6	0	13	20	20	0	82	15	6	8	52
1999	22024	Alquézar	95	61	34	30	4	50	22	18	4	6	3	3	0	5	9	9	0	72	10	4	5	4
1999	22025	Altorricón	307	198	109	64	45	117	68	38	30	45	8	7	1	36	33	19	14	167	29	14	30	65
1999	22027	Angüés	105	71	34	32	2	63	31	29	2	6	0	0	0	2	3	3	0	61	12	5	6	20
1999	22028	Ansó	35	26	9	7	2	22	3	2	1	0	2	1	1	4	4	4	0	14	3	4	1	13
1999	22029	Antillón	59	44	15	14	1	30	9	8	1	12	4	4	0	2	2	2	0	38	3	1	0	16
1999	22032	Aragüés del Puerto	20	14	6	4	2	7	5	3	2	3	1	1	0	4	0	0	0	14	2	1	0	3
1999	22035	Arén	72	51	21	19	2	47	17	15	2	3	2	2	0	1	2	2	0	46	5	0	9	12
1999	22036	Argavieso	30	16	14	14	0	15	13	13	0	0	0	0	0	1	1	1	0	23	2	1	2	2
1999	22037	Arguis	24	17	7	7	0	12	5	5	0	3	0	0	0	2	2	2	0	18	4	1	0	1
1999	22039	Ayerbe	187	130	57	53	4	111	41	37	4	11	5	5	0	8	11	11	0	107	28	10	14	26
1999	22040	Azanuy-Alins	140	93	47	41	6	67	28	22	6	15	6	6	0	11	13	13	0	105	11	2	6	15
1999	22041	Azara	81	34	47	46	1	21	33	32	1	6	3	3	0	7	11	11	0	63	5	5	5	2
1999	22042	Azlor	80	46	34	33	1	34	22	21	1	9	3	3	0	3	9	9	0	54	11	2	6	5
1999	22043	Baells	87	75	12	9	3	64	11	8	3	5	0	0	0	6	1	1	0	39	12	1	5	30
1999	22044	Bailo	115	78	37	27	10	55	22	14	8	7	1	0	1	16	14	13	1	55	15	5	9	27
1999	22045	Baldellou	93	71	22	21	1	65	18	17	1	5	0	0	0	1	4	4	0	53	16	7	6	10
1999	22046	Ballobar	364	261	103	101	2	122	47	47	0	69	26	26	0	70	30	28	2	207	63	13	6	75
1999	22047	Banastás	4	2	2	2	0	2	1	1	0	0	0	0	0	0	1	1	0	2	0	0	1	1
1999	22048	Barbastro	727	434	293	286	7	332	220	214	6	71	28	28	0	31	45	44	1	508	99	36	26	54
1999	22049	Barbués	51	38	13	9	4	29	10	6	4	5	2	2	0	4	1	1	0	30	3	3	1	13
1999	22050	Barbuñales	46	20	26	24	2	19	20	19	1	0	1	1	0	1	5	4	1	39	4	1	2	0
1999	22051	Bárcabo	62	48	14	14	0	30	8	8	0	15	1	1	0	3	5	5	0	24	13	4	2	19
1999	22052	Belver de Cinca	531	355	176	136	40	200	81	53	28	64	23	22	1	91	72	61	11	278	49	11	41	136
1999	22053	Benabarre	333	224	109	100	9	179	97	91	6	34	4	4	0	11	8	5	3	214	34	13	19	53
1999	22054	Benasque	45	29	16	10	6	19	8	5	3	5	1	1	0	5	7	4	3	27	4	0	7	7
1999	22055	Berbegal	138	94	44	40	4	72	25	21	4	10	5	5	0	12	14	14	0	75	16	7	7	32
1999	22057	Bielsa	46	30	16	15	1	22	9	8	1	3	1	1	0	5	6	6	0	9	7	1	10	18
1999	22058	Bierge	126	83	43	42	1	68	20	19	1	8	5	5	0	7	18	18	0	97	8	0	6	14
1999	22059	Biescas	151	96	55	50	5	70	28	23	5	12	0	0	0	14	27	27	0	69	16	11	33	19
1999	22060	Binaced	469	328	141	124	17	237	101	85	16	64	15	14	1	27	25	25	0	248	58	8	33	109
1999	22061	Binéfar	268	162	106	74	32	142	93	62	31	15	7	7	0	5	6	5	1	187	16	6	7	34
1999	22062	Bisaurri	67	56	11	6	5	35	10	5	5	10	1	1	0	11	0	0	0	7	6	5	3	46
1999	22063	Biscarrués	84	52	32	25	7	42	17	10	7	3	2	2	0	7	13	13	0	45	11	5	8	14
1999	22064	Blecua y Torres	65	43	22	19	3	37	17	15	2	4	1	0	1	2	4	4	0	35	6	2	5	15
1999	22066	Boltaña	54	37	17	12	5	31	13	11	2	0	1	1	0	6	3	0	3	19	9	2	11	13
1999	22067	Bonansa	23	15	8	7	1	8	3	2	1	2	1	1	0	5	4	4	0	9	3	2	0	9
1999	22068	Borau	9	7	2	0	2	7	2	0	2	0	0	0	0	0	0	0	0	1	2	1	0	5
1999	22069	Broto	83	64	19	7	12	42	12	6	6	13	5	1	4	9	2	0	2	22	7	3	12	39
1999	22072	Caldearenas	60	35	25	23	2	32	17	15	2	1	0	0	0	2	8	8	0	33	6	3	1	14
1999	22074	Campo	13	11	2	2	0	10	1	1	0	1	1	1	0	0	0	0	0	4	0	1	2	6
1999	22075	Camporrells	74	48	26	20	6	43	24	18	6	3	0	0	0	2	2	2	0	47	13	0	2	12
1999	22076	Canal de Berdún	135	112	23	20	3	88	16	13	3	8	2	2	0	16	5	5	0	47	14	3	16	55
1999	22077	Candasnos	117	73	44	35	9	57	32	24	8	5	6	5	1	11	6	6	0	47	21	11	14	24
1999	22078	Canfranc	6	1	5	5	0	1	1	1	0	0	0	0	0	0	4	4	0	4	0	0	2	0
1999	22079	Capdesaso	24	17	7	3	4	17	7	3	4	0	0	0	0	0	0	0	0	4	4	5	9	2
1999	22080	Capella	112	78	34	29	5	61	19	15	4	11	7	7	0	6	8	7	1	63	9	4	12	24
1999	22081	Casbas de Huesca	130	85	45	38	7	77	29	25	4	2	4	3	1	6	12	10	2	60	19	9	11	28
1999	22082	Castejón del Puente	64	41	23	20	3	37	20	17	3	1	2	2	0	3	1	1	0	30	10	1	3	20
1999	22083	Castejón de Monegros	203	151	52	46	6	106	29	23	6	14	5	5	0	31	18	18	0	112	21	22	8	23
1999	22084	Castejón de Sos	32	28	4	4	0	17	1	1	0	3	0	0	0	8	3	3	0	11	3	0	4	14
1999	22085	Castelflorite	74	48	26	14	12	34	22	10	12	7	1	1	0	7	3	3	0	26	8	13	7	19
1999	22086	Castiello de Jaca	14	7	7	3	4	6	7	3	4	1	0	0	0	0	0	0	0	2	3	3	3	3
1999	22087	Castigaleu	25	18	7	7	0	15	3	3	0	0	0	0	0	3	4	4	0	5	2	0	7	11
1999	22088	Castillazuelo	124	88	36	35	1	61	13	13	0	20	1	1	0	7	22	21	1	65	28	12	16	2
1999	22089	Castillonroy	155	121	34	23	11	64	22	13	9	29	5	4	1	28	7	6	1	82	21	9	9	34
1999	22090	Colungo	94	65	29	26	3	34	20	17	3	25	1	1	0	6	8	8	0	57	20	3	1	13
1999	22094	Chalamera	55	46	9	8	1	29	7	6	1	9	1	1	0	8	1	1	0	28	10	2	4	11
1999	22095	Chía	21	18	3	2	1	11	1	0	1	3	0	0	0	4	2	2	0	4	3	1	2	11
1999	22096	Chimillas	17	11	6	5	1	8	6	5	1	0	0	0	0	3	0	0	0	6	3	2	2	3
1999	22099	Esplús	205	137	68	57	11	107	52	42	10	16	5	5	0	14	11	10	1	119	25	13	8	26
1999	22102	Estada	60	36	24	24	0	23	15	15	0	11	5	5	0	2	4	4	0	30	10	3	10	6
1999	22103	Estadilla	254	182	72	62	10	117	45	38	7	51	16	14	2	14	11	10	1	140	40	9	13	48
1999	22105	Estopiñán del Castillo	121	95	26	21	5	69	20	15	5	18	1	1	0	8	5	5	0	76	16	7	3	18
1999	22106	Fago	9	6	3	2	1	3	2	1	1	1	0	0	0	2	1	1	0	7	0	1	0	1
1999	22107	Fanlo	9	8	1	0	1	5	1	0	1	1	0	0	0	2	0	0	0	3	0	1	3	2
1999	22109	Fiscal	55	46	9	5	4	31	8	4	4	2	1	1	0	13	0	0	0	7	5	1	19	23
1999	22110	Fonz	271	180	91	72	19	145	74	57	17	19	5	3	2	16	12	12	0	160	31	13	20	43
1999	22111	Foradada del Toscar	77	61	16	12	4	31	12	8	4	16	2	2	0	14	2	2	0	20	9	6	14	28
1999	22112	Fraga	1948	1375	573	516	57	741	322	281	41	341	98	89	9	293	153	146	7	872	365	118	87	503
1999	22113	Fueva (La)	202	137	65	49	16	92	46	34	12	31	10	6	4	14	9	9	0	99	18	5	73	7
1999	22114	Gistaín	85	55	30	22	8	37	14	10	4	6	3	1	2	12	13	11	2	39	15	2	7	22
1999	22115	Grado (El)	190	120	70	69	1	91	55	54	1	18	7	7	0	11	8	8	0	121	25	11	11	22
1999	22116	Grañén	308	202	106	83	23	155	82	67	15	29	7	6	1	18	17	10	7	156	43	20	33	48
1999	22117	Graus	450	309	141	123	18	204	99	84	15	61	16	14	2	44	26	25	1	253	39	18	50	88
1999	22119	Gurrea de Gállego	315	207	108	85	23	194	83	61	22	6	10	10	0	7	15	14	1	131	34	17	33	89
1999	22122	Hoz de Jaca	10	7	3	3	0	6	2	2	0	0	0	0	0	1	1	1	0	3	2	0	3	2
1999	22124	Huerto	128	92	36	30	6	71	28	22	6	11	5	5	0	10	3	3	0	67	12	10	15	23
1999	22125	Huesca	440	285	155	145	10	224	111	101	10	23	10	10	0	38	34	34	0	265	50	36	28	54
1999	22126	Ibieca	25	14	11	10	1	11	9	8	1	1	0	0	0	2	2	2	0	13	2	1	5	2
1999	22127	Igriés	57	37	20	18	2	28	10	8	2	3	1	1	0	6	9	9	0	28	7	7	4	9
1999	22128	Ilche	109	79	30	22	8	70	23	16	7	3	5	4	1	6	2	2	0	37	20	11	5	36
1999	22129	Isábena	99	76	23	18	5	52	21	16	5	20	1	1	0	4	1	1	0	49	11	9	6	24
1999	22130	Jaca	410	281	129	113	16	184	79	69	10	30	9	6	3	67	41	38	3	172	64	26	12	130
1999	22131	Jasa	19	13	6	4	2	8	3	1	2	2	1	1	0	3	2	2	0	7	4	1	3	4
1999	22133	Labuerda	10	9	1	1	0	9	1	1	0	0	0	0	0	0	0	0	0	3	0	0	1	6
1999	22135	Laluenga	104	78	26	22	4	60	11	7	4	4	1	1	0	14	14	14	0	49	8	8	11	27
1999	22136	Lalueza	244	171	73	51	22	155	64	44	20	11	2	1	1	5	7	6	1	102	30	27	30	54
1999	22137	Lanaja	433	275	158	133	25	193	102	80	22	38	9	9	0	44	47	44	3	281	50	11	39	49
1999	22139	Laperdiguera	27	21	6	4	2	16	5	3	2	1	0	0	0	4	1	1	0	12	5	1	2	7
1999	22141	Lascellas-Ponzano	85	54	31	29	2	37	25	23	2	10	2	2	0	7	4	4	0	47	10	3	9	16
1999	22142	Lascuarre	37	26	11	10	1	20	10	9	1	4	0	0	0	2	1	1	0	18	4	1	3	11
1999	22143	Laspaúles	70	51	19	13	6	33	13	8	5	11	2	1	1	7	4	4	0	13	4	12	12	29
1999	22144	Laspuña	37	25	12	11	1	21	9	8	1	2	0	0	0	2	3	3	0	14	12	0	3	8
1999	22149	Loarre	166	107	59	52	7	84	31	25	6	11	5	4	1	12	23	23	0	96	20	10	12	23
1999	22150	Loporzano	245	163	82	72	10	133	52	44	8	19	6	6	0	11	24	22	2	169	16	8	16	33
1999	22151	Loscorrales	53	40	13	10	3	33	8	6	2	1	1	1	0	6	4	3	1	24	15	1	2	9
1999	22155	Monesma y Cajigar	47	43	4	2	2	27	4	2	2	7	0	0	0	9	0	0	0	12	6	4	6	19
1999	22156	Monflorite-Lascasas	62	42	20	18	2	29	18	17	1	5	1	0	1	8	1	1	0	29	8	4	3	18
1999	22157	Montanuy	136	95	41	31	10	53	17	13	4	16	3	1	2	26	21	17	4	16	24	11	6	79
1999	22158	Monzón	881	509	372	340	32	394	265	233	32	64	27	27	0	51	80	80	0	511	161	33	37	124
1999	22160	Naval	43	28	15	10	5	27	15	10	5	1	0	0	0	0	0	0	0	16	7	4	3	13
1999	22162	Novales	37	23	14	10	4	21	14	10	4	0	0	0	0	2	0	0	0	24	2	3	3	5
1999	22163	Nueno	93	57	36	35	1	49	29	28	1	4	2	2	0	4	5	5	0	65	8	1	7	10
1999	22164	Olvena	38	22	16	16	0	13	9	9	0	3	2	2	0	6	5	5	0	17	6	7	3	5
1999	22165	Ontiñena	201	142	59	45	14	102	36	25	11	24	10	8	2	16	13	12	1	141	20	19	4	16
1999	22167	Osso de Cinca	249	174	75	60	15	101	38	27	11	32	13	12	1	41	24	21	3	89	53	20	20	64
1999	22168	Palo	12	7	5	5	0	6	5	5	0	1	0	0	0	0	0	0	0	6	1	2	3	0
1999	22170	Panticosa	29	14	15	12	3	13	11	8	3	1	1	1	0	0	3	3	0	9	4	2	5	9
1999	22172	Peñalba	167	87	80	66	14	66	52	41	11	6	10	9	1	15	18	16	2	78	26	20	12	26
1999	22173	Peñas de Riglos (Las)	91	48	43	39	4	37	29	26	3	5	3	3	0	6	11	10	1	51	10	2	8	16
1999	22174	Peralta de Alcofea	204	146	58	56	2	133	42	40	2	6	8	8	0	7	8	8	0	121	13	6	12	51
1999	22175	Peralta de Calasanz	179	130	49	35	14	111	42	32	10	10	5	2	3	9	2	1	1	101	22	10	9	34
1999	22176	Peraltilla	72	35	37	37	0	26	27	27	0	8	1	1	0	1	9	9	0	60	7	1	1	3
1999	22177	Perarrúa	36	25	11	9	2	17	10	8	2	2	0	0	0	6	1	1	0	14	3	6	7	5
1999	22178	Pertusa	39	26	13	12	1	22	11	10	1	1	1	1	0	3	1	1	0	21	4	2	1	10
1999	22181	Piracés	52	34	18	13	5	31	14	10	4	1	2	1	1	2	2	2	0	29	5	6	5	6
1999	22182	Plan	115	83	32	24	8	44	22	17	5	12	4	1	3	27	6	6	0	51	15	9	9	31
1999	22184	Poleñino	84	61	23	21	2	55	17	15	2	2	0	0	0	4	6	6	0	38	7	5	4	27
1999	22186	Pozán de Vero	151	104	47	45	2	59	22	20	2	21	3	3	0	24	22	22	0	76	32	24	15	1
1999	22187	Puebla de Castro (La)	86	49	37	34	3	34	24	21	3	8	3	3	0	7	10	10	0	63	9	4	3	7
1999	22188	Puente de Montañana	20	14	6	6	0	10	4	4	0	3	0	0	0	1	2	2	0	15	2	0	0	3
1999	22189	Puértolas	38	19	19	14	5	14	15	10	5	2	1	1	0	3	3	3	0	17	4	0	15	2
1999	22190	Pueyo de Araguás (El)	44	27	17	10	7	19	12	8	4	3	2	0	2	5	3	2	1	9	7	2	5	21
1999	22193	Pueyo de Santa Cruz	60	38	22	19	3	24	17	14	3	3	1	1	0	11	4	4	0	44	6	2	3	5
1999	22195	Quicena	15	11	4	3	1	6	2	1	1	2	0	0	0	3	2	2	0	7	4	1	0	3
1999	22197	Robres	203	126	77	64	13	98	58	47	11	12	4	4	0	16	15	13	2	98	15	32	22	22
1999	22199	Sabiñánigo	264	174	90	87	3	126	56	53	3	19	8	8	0	29	26	26	0	153	37	12	13	42
1999	22200	Sahún	51	31	20	12	8	21	12	5	7	6	2	2	0	4	6	5	1	20	7	1	8	15
1999	22201	Salas Altas	207	149	58	54	4	90	31	27	4	34	2	2	0	25	25	25	0	107	35	24	29	7
1999	22202	Salas Bajas	107	67	40	39	1	41	17	16	1	15	2	2	0	11	21	21	0	55	26	14	8	1
1999	22203	Salillas	31	22	9	4	5	19	9	4	5	1	0	0	0	2	0	0	0	15	4	3	2	6
1999	22204	Sallent de Gállego	102	57	45	31	14	51	35	23	12	2	1	1	0	4	9	7	2	46	10	2	26	17
1999	22205	San Esteban de Litera	336	221	115	91	24	180	97	74	23	22	4	3	1	19	14	14	0	195	31	17	15	60
1999	22206	Sangarrén	68	46	22	21	1	40	17	16	1	1	2	2	0	5	3	3	0	41	3	2	4	17
1999	22207	San Juan de Plan	73	59	14	9	5	35	3	2	1	8	3	2	1	16	8	5	3	25	13	4	2	28
1999	22208	Santa Cilia	34	18	16	12	4	13	12	9	3	2	0	0	0	3	4	3	1	10	7	2	4	10
1999	22209	Santa Cruz de la Serós	36	30	6	5	1	15	4	3	1	4	1	1	0	11	1	1	0	11	5	3	2	14
1999	22212	Santaliestra y San Quílez	18	14	4	4	0	11	3	3	0	1	0	0	0	2	1	1	0	10	0	0	1	7
1999	22213	Sariñena	583	357	226	195	31	259	148	125	23	44	28	25	3	54	50	45	5	255	76	104	54	80
1999	22214	Secastilla	57	38	19	16	3	21	11	10	1	12	2	2	0	5	6	4	2	29	14	2	4	8
1999	22215	Seira	30	21	9	6	3	12	6	5	1	7	1	0	1	2	2	1	1	6	2	3	0	19
1999	22217	Sena	181	89	92	82	10	69	77	68	9	11	8	7	1	9	7	7	0	76	37	17	24	24
1999	22218	Senés de Alcubierre	24	9	15	12	3	8	9	6	3	1	2	2	0	0	4	4	0	15	1	3	2	3
1999	22220	Sesa	62	39	23	21	2	37	20	18	2	0	1	1	0	2	2	2	0	44	6	2	4	6
1999	22221	Sesué	18	16	2	2	0	11	1	1	0	3	0	0	0	2	1	1	0	2	1	0	10	5
1999	22222	Siétamo	130	92	38	28	10	68	25	19	6	6	1	1	0	18	12	8	4	76	19	15	6	11
1999	22223	Sopeira	21	17	4	3	1	15	4	3	1	2	0	0	0	0	0	0	0	10	1	0	6	4
1999	22225	Tamarite de Litera	830	557	273	238	35	307	163	134	29	133	30	26	4	117	80	78	2	459	123	27	84	123
1999	22226	Tardienta	175	113	62	56	6	90	43	39	4	9	6	5	1	14	13	12	1	102	19	13	11	24
1999	22227	Tella-Sin	14	8	6	4	2	8	6	4	2	0	0	0	0	0	0	0	0	4	2	1	4	3
1999	22228	Tierz	29	21	8	4	4	16	8	4	4	1	0	0	0	4	0	0	0	15	5	3	4	2
1999	22229	Tolva	78	58	20	19	1	47	17	16	1	8	3	3	0	3	0	0	0	51	3	1	7	16
1999	22230	Torla-Ordesa	52	43	9	7	2	32	6	5	1	6	3	2	1	5	0	0	0	13	4	2	12	21
1999	22232	Torralba de Aragón	47	29	18	17	1	22	12	11	1	4	2	2	0	3	4	4	0	25	3	2	2	14
1999	22233	Torre la Ribera	53	40	13	11	2	35	11	10	1	2	2	1	1	3	0	0	0	32	8	1	1	11
1999	22234	Torrente de Cinca	259	186	73	63	10	92	29	23	6	49	16	14	2	45	28	26	2	68	92	20	38	41
1999	22235	Torres de Alcanadre	41	27	14	12	2	22	12	10	2	2	1	1	0	3	1	1	0	27	2	2	4	6
1999	22236	Torres de Barbués	60	41	19	18	1	35	14	13	1	2	1	1	0	4	4	4	0	42	5	1	1	10
1999	22239	Tramaced	52	34	18	16	2	23	9	8	1	3	5	4	1	8	4	4	0	23	12	2	1	11
1999	22242	Valfarta	66	41	25	22	3	30	10	9	1	2	4	4	0	9	11	9	2	39	6	9	4	6
1999	22243	Valle de Bardají	16	14	2	1	1	10	2	1	1	3	0	0	0	1	0	0	0	2	0	0	4	10
1999	22244	Valle de Lierp	18	16	2	2	0	12	1	1	0	2	0	0	0	2	1	1	0	9	0	0	1	8
1999	22245	Velilla de Cinca	145	95	50	42	8	56	22	15	7	16	5	5	0	23	23	22	1	75	25	13	11	21
1999	22246	Beranuy	72	59	13	12	1	44	10	10	0	8	1	0	1	7	2	2	0	42	9	0	6	15
1999	22247	Viacamp y Litera	33	25	8	8	0	15	5	5	0	6	1	1	0	4	2	2	0	21	2	1	1	8
1999	22248	Vicién	11	7	4	3	1	4	4	3	1	1	0	0	0	2	0	0	0	3	4	1	1	2
1999	22249	Villanova	10	5	5	3	2	4	4	2	2	1	0	0	0	0	1	1	0	5	0	0	0	5
1999	22250	Villanúa	10	4	6	1	5	4	6	1	5	0	0	0	0	0	0	0	0	4	1	3	0	2
1999	22251	Villanueva de Sigena	183	109	74	60	14	63	46	36	10	25	7	5	2	21	21	19	2	112	27	12	2	28
1999	22252	Yebra de Basa	30	14	16	13	3	12	8	5	3	0	0	0	0	2	8	8	0	19	1	1	5	4
1999	22253	Yésero	11	5	6	6	0	5	1	1	0	0	1	1	0	0	4	4	0	4	0	0	5	2
1999	22254	Zaidín	565	362	203	125	78	194	123	63	60	59	19	16	3	109	61	46	15	239	80	69	50	123
1999	22901	Valle de Hecho	182	125	57	47	10	64	27	21	6	21	2	2	0	40	28	24	4	84	27	17	10	43
1999	22902	Puente la Reina de Jaca	80	61	19	17	2	37	12	10	2	6	3	3	0	18	4	4	0	43	9	4	0	21
1999	22903	San Miguel del Cinca	284	190	94	75	19	130	62	44	18	26	13	12	1	34	19	19	0	162	36	14	20	49
1999	22904	Sotonera (La)	485	295	190	182	8	230	115	108	7	37	11	10	1	28	64	64	0	342	72	15	7	40
1999	22905	Lupiñén-Ortilla	97	51	46	46	0	41	28	28	0	1	3	3	0	9	15	15	0	60	7	8	16	4
1999	22906	Santa María de Dulcis	124	83	41	32	9	50	27	20	7	31	3	2	1	2	11	10	1	58	22	7	9	28
1999	22907	Aínsa-Sobrarbe	195	126	69	59	10	96	47	40	7	15	1	1	0	15	21	18	3	85	17	10	15	66
1999	22908	Hoz y Costeán	187	109	78	71	7	80	49	43	6	15	8	8	0	14	21	20	1	129	18	5	8	25
1999	22909	Vencillón	137	64	73	51	22	43	52	31	21	10	3	3	0	11	18	17	1	36	20	28	23	29
1999	44001	Ababuj	36	28	8	7	1	19	5	4	1	8	2	2	0	1	1	1	0	18	3	4	4	7
1999	44002	Abejuela	19	6	13	12	1	5	7	6	1	1	5	5	0	0	1	1	0	7	3	1	2	6
1999	44003	Aguatón	11	10	1	1	0	7	1	1	0	2	0	0	0	1	0	0	0	5	1	0	1	3
1999	44004	Aguaviva	130	99	31	30	1	72	15	15	0	23	7	6	1	4	9	9	0	79	16	9	5	21
1999	44005	Aguilar del Alfambra	35	22	13	11	2	16	7	5	2	4	5	5	0	2	1	1	0	15	5	2	3	10
1999	44006	Alacón	173	142	31	30	1	96	16	15	1	42	6	6	0	4	9	9	0	127	13	3	6	24
1999	44007	Alba	94	44	50	46	4	37	31	27	4	5	8	8	0	2	11	11	0	48	7	1	14	24
1999	44008	Albalate del Arzobispo	762	472	290	282	8	335	191	186	5	102	33	31	2	35	66	65	1	590	102	17	13	40
1999	44009	Albarracín	88	49	39	35	4	37	25	22	3	8	3	2	1	4	11	11	0	45	13	5	11	11
1999	44010	Albentosa	72	28	44	41	3	20	28	25	3	4	8	8	0	4	8	8	0	51	3	3	3	10
1999	44011	Alcaine	10	8	2	1	1	7	2	1	1	1	0	0	0	0	0	0	0	2	1	0	3	4
1999	44012	Alcalá de la Selva	55	39	16	12	4	31	15	11	4	4	0	0	0	4	1	1	0	26	4	0	1	24
1999	44013	Alcañiz	1385	938	447	412	35	606	268	243	25	218	74	70	4	114	105	99	6	805	179	113	45	227
1999	44014	Alcorisa	1014	644	370	366	4	331	178	174	4	179	43	43	0	134	149	149	0	872	58	46	3	28
1999	44016	Alfambra	221	90	131	116	15	66	85	77	8	18	21	19	2	6	25	20	5	145	18	11	8	34
1999	44017	Aliaga	88	43	45	35	10	29	35	30	5	9	3	2	1	5	7	3	4	46	4	8	6	23
1999	44018	Almohaja	5	4	1	1	0	3	1	1	0	0	0	0	0	1	0	0	0	2	0	0	1	2
1999	44019	Alobras	24	15	9	7	2	8	7	5	2	1	0	0	0	6	2	2	0	10	1	2	0	11
1999	44020	Alpeñés	11	9	2	1	1	8	2	1	1	0	0	0	0	1	0	0	0	4	0	2	0	5
1999	44021	Allepuz	62	46	16	13	3	35	12	11	1	6	1	1	0	5	3	1	2	20	7	3	15	17
1999	44022	Alloza	547	384	163	163	0	222	74	74	0	99	12	12	0	63	77	77	0	484	29	12	5	15
1999	44023	Allueva	1	1	0	0	0	1	0	0	0	0	0	0	0	0	0	0	0	0	1	0	0	0
1999	44024	Anadón	11	10	1	1	0	4	0	0	0	2	0	0	0	4	1	1	0	5	2	0	2	2
1999	44025	Andorra	991	733	258	255	3	378	114	112	2	244	45	44	1	111	99	99	0	884	58	9	7	32
1999	44026	Arcos de las Salinas	29	12	17	15	2	8	11	9	2	2	3	3	0	2	3	3	0	16	2	2	0	9
1999	44027	Arens de Lledó	145	99	46	37	9	56	22	16	6	28	9	8	1	15	15	13	2	50	28	15	12	40
1999	44028	Argente	86	75	11	7	4	69	9	7	2	6	0	0	0	0	2	0	2	41	19	11	1	13
1999	44029	Ariño	100	68	32	32	0	66	26	26	0	1	2	2	0	1	4	4	0	80	14	0	0	5
1999	44031	Azaila	90	57	33	31	2	40	15	15	0	10	7	5	2	7	11	11	0	67	8	2	1	10
1999	44032	Bádenas	5	1	4	4	0	1	3	3	0	0	0	0	0	0	1	1	0	4	0	0	0	1
1999	44033	Báguena	226	127	99	91	8	106	87	79	8	14	2	2	0	7	10	10	0	149	47	15	3	11
1999	44034	Bañón	46	43	3	2	1	34	3	2	1	7	0	0	0	2	0	0	0	7	4	3	5	27
1999	44035	Barrachina	39	32	7	6	1	23	2	1	1	7	4	4	0	2	1	1	0	18	8	4	2	7
1999	44036	Bea	8	5	3	3	0	1	3	3	0	1	0	0	0	3	0	0	0	5	2	0	0	1
1999	44037	Beceite	126	84	42	35	7	63	37	30	7	10	1	1	0	11	4	4	0	73	16	2	13	22
1999	44038	Belmonte de San José	152	109	43	37	6	71	22	20	2	28	8	7	1	10	13	10	3	88	28	7	4	25
1999	44039	Bello	145	115	30	25	5	86	19	16	3	25	6	5	1	4	5	4	1	98	12	6	9	18
1999	44040	Berge	138	95	43	39	4	55	27	24	3	18	8	8	0	22	8	7	1	83	25	11	3	15
1999	44041	Bezas	10	4	6	6	0	3	5	5	0	1	0	0	0	0	1	1	0	7	2	0	0	1
1999	44042	Blancas	70	61	9	8	1	39	6	5	1	20	3	3	0	2	0	0	0	31	3	4	11	21
1999	44043	Blesa	70	45	25	24	1	38	14	13	1	6	2	2	0	1	9	9	0	45	8	1	5	9
1999	44044	Bordón	35	26	9	8	1	18	4	3	1	7	1	1	0	1	4	4	0	12	7	0	0	14
1999	44045	Bronchales	32	23	9	7	2	14	7	5	2	5	1	1	0	4	1	1	0	10	5	4	3	10
1999	44046	Bueña	42	34	8	8	0	27	6	6	0	7	0	0	0	0	2	2	0	24	2	0	2	11
1999	44047	Burbáguena	187	155	32	32	0	109	21	21	0	42	2	2	0	4	9	9	0	137	24	9	3	12
1999	44048	Cabra de Mora	22	17	5	3	2	14	3	2	1	3	2	1	1	0	0	0	0	6	4	2	2	8
1999	44049	Calaceite	510	316	194	166	28	176	107	88	19	70	25	22	3	70	62	56	6	253	85	50	8	110
1999	44050	Calamocha	566	392	174	151	23	272	125	105	20	81	18	15	3	39	31	31	0	214	149	36	40	113
1999	44051	Calanda	807	534	273	250	23	319	139	127	12	123	44	38	6	92	90	85	5	518	127	29	20	108
1999	44052	Calomarde	16	12	4	3	1	7	2	1	1	4	1	1	0	1	1	1	0	5	1	1	2	7
1999	44053	Camañas	58	49	9	9	0	40	4	4	0	7	1	1	0	2	4	4	0	20	5	5	6	20
1999	44054	Camarena de la Sierra	20	10	10	4	6	5	6	4	2	3	1	0	1	2	3	0	3	4	7	0	4	5
1999	44055	Camarillas	43	27	16	14	2	14	14	13	1	7	0	0	0	6	2	1	1	24	3	1	7	8
1999	44056	Caminreal	243	177	66	57	9	120	47	42	5	43	13	11	2	14	6	4	2	104	46	27	19	45
1999	44059	Cantavieja	194	100	94	78	16	58	64	52	12	32	25	22	3	10	5	4	1	79	16	18	6	75
1999	44060	Cañada de Benatanduz	24	17	7	5	2	16	6	4	2	1	0	0	0	0	1	1	0	5	3	1	0	15
1999	44061	Cañada de Verich (La)	19	16	3	3	0	14	2	2	0	1	0	0	0	1	1	1	0	14	2	1	0	2
1999	44062	Cañada Vellida	48	23	25	19	6	14	15	11	4	2	0	0	0	7	10	8	2	23	3	6	3	13
1999	44063	Cañizar del Olivar	20	14	6	5	1	8	5	4	1	5	0	0	0	1	1	1	0	11	7	0	0	2
1999	44064	Cascante del Río	28	15	13	12	1	11	11	10	1	3	2	2	0	1	0	0	0	12	7	1	0	8
1999	44065	Castejón de Tornos	56	49	7	7	0	33	3	3	0	16	2	2	0	0	2	2	0	32	10	4	3	7
1999	44066	Castel de Cabra	28	26	2	2	0	25	2	2	0	1	0	0	0	0	0	0	0	17	0	1	7	3
1999	44067	Castelnou	30	20	10	5	5	14	9	4	5	6	0	0	0	0	1	1	0	13	7	2	0	8
1999	44068	Castelserás	156	116	40	37	3	84	26	24	2	19	5	4	1	13	9	9	0	77	40	9	11	19
1999	44070	Castellar (El)	28	23	5	4	1	19	4	3	1	3	1	1	0	1	0	0	0	8	2	1	1	16
1999	44071	Castellote	360	263	97	95	2	188	57	56	1	48	13	13	0	27	27	26	1	200	76	22	8	54
1999	44074	Cedrillas	118	56	62	61	1	43	45	45	0	11	7	6	1	2	10	10	0	76	5	2	14	16
1999	44075	Celadas	163	104	59	54	5	74	39	36	3	23	13	13	0	7	7	5	2	81	22	9	23	25
1999	44076	Cella	526	215	311	290	21	112	263	246	17	97	32	31	1	6	16	13	3	389	36	22	22	54
1999	44077	Cerollera (La)	61	37	24	16	8	35	20	13	7	2	1	1	0	0	3	2	1	52	3	3	2	1
1999	44080	Codoñera (La)	155	114	41	38	3	54	12	11	1	28	12	11	1	32	17	16	1	62	29	14	10	39
1999	44082	Corbalán	32	18	14	10	4	14	11	7	4	4	2	2	0	0	1	1	0	9	6	1	1	14
1999	44084	Cortes de Aragón	24	18	6	6	0	14	4	4	0	4	1	1	0	0	1	1	0	15	3	1	1	3
1999	44085	Cosa	39	34	5	2	3	25	3	0	3	5	0	0	0	4	2	2	0	4	10	1	2	22
1999	44086	Cretas	276	187	89	80	9	135	49	45	4	27	16	15	1	25	24	20	4	142	24	11	2	92
1999	44087	Crivillén	58	34	24	23	1	19	7	7	0	10	2	2	0	5	15	14	1	51	1	2	0	4
1999	44088	Cuba (La)	24	18	6	6	0	13	5	5	0	5	1	1	0	0	0	0	0	14	0	4	4	2
1999	44089	Cubla	28	10	18	18	0	7	11	11	0	2	1	1	0	1	6	6	0	22	0	2	2	2
1999	44090	Cucalón	27	22	5	5	0	15	5	5	0	1	0	0	0	6	0	0	0	15	2	1	4	5
1999	44092	Cuervo (El)	27	8	19	16	3	4	14	12	2	4	2	1	1	0	3	3	0	14	7	0	1	5
1999	44093	Cuevas de Almudén	45	18	27	26	1	12	16	15	1	4	3	3	0	2	8	8	0	33	5	1	0	2
1999	44094	Cuevas Labradas	42	24	18	16	2	16	17	15	2	8	1	1	0	0	0	0	0	18	8	2	4	10
1999	44096	Ejulve	53	40	13	13	0	27	7	7	0	11	1	1	0	2	5	5	0	37	1	0	3	12
1999	44097	Escorihuela	93	38	55	50	5	23	41	37	4	13	3	3	0	2	11	10	1	49	13	7	9	14
1999	44099	Escucha	59	36	23	23	0	23	10	10	0	5	1	1	0	8	12	12	0	32	7	2	5	10
1999	44100	Estercuel	61	34	27	26	1	30	20	19	1	3	1	1	0	1	6	6	0	26	29	3	2	0
1999	44101	Ferreruela de Huerva	47	38	9	8	1	34	4	3	1	4	3	3	0	0	2	2	0	25	9	5	4	4
1999	44102	Fonfría	15	15	0	0	0	9	0	0	0	4	0	0	0	2	0	0	0	2	2	2	1	8
1999	44103	Formiche Alto	41	15	26	21	5	13	17	14	3	1	6	4	2	1	3	3	0	29	5	1	0	6
1999	44105	Fórnoles	116	75	41	37	4	52	26	24	2	16	4	3	1	7	11	10	1	67	18	2	3	25
1999	44106	Fortanete	90	46	44	40	4	38	32	28	4	7	9	9	0	1	3	3	0	56	5	6	2	20
1999	44107	Foz-Calanda	120	92	28	26	2	68	18	17	1	13	5	4	1	11	5	5	0	55	25	0	3	36
1999	44108	Fresneda (La)	281	179	102	76	26	118	44	34	10	37	32	20	12	24	26	22	4	123	76	23	20	37
1999	44109	Frías de Albarracín	24	21	3	3	0	17	2	2	0	3	0	0	0	1	1	1	0	10	1	0	1	12
1999	44110	Fuenferrada	21	11	10	9	1	11	6	6	0	0	0	0	0	0	4	3	1	8	5	2	1	5
1999	44111	Fuentes Calientes	49	40	9	8	1	32	7	6	1	5	0	0	0	3	2	2	0	22	4	2	2	19
1999	44112	Fuentes Claras	234	167	67	67	0	120	44	44	0	28	11	11	0	19	12	12	0	121	27	15	17	50
1999	44113	Fuentes de Rubielos	9	5	4	3	1	5	4	3	1	0	0	0	0	0	0	0	0	7	1	0	0	1
1999	44114	Fuentespalda	111	74	37	27	10	55	29	22	7	15	5	3	2	4	3	2	1	55	13	5	8	29
1999	44115	Galve	78	35	43	34	9	11	27	20	7	9	3	3	0	15	13	11	2	49	12	4	3	10
1999	44116	Gargallo	22	18	4	4	0	15	2	2	0	2	0	0	0	1	2	2	0	13	4	0	0	4
1999	44117	Gea de Albarracín	71	33	38	35	3	19	27	24	3	11	3	3	0	3	8	8	0	43	11	2	0	15
1999	44118	Ginebrosa (La)	132	103	29	26	3	64	19	16	3	23	2	2	0	16	8	8	0	72	5	9	7	39
1999	44119	Griegos	28	22	6	5	1	17	3	2	1	3	1	1	0	2	2	2	0	11	2	2	2	11
1999	44120	Guadalaviar	66	45	21	10	11	27	12	5	7	16	5	2	3	2	4	3	1	12	13	7	2	32
1999	44121	Gúdar	25	20	5	3	2	14	5	3	2	2	0	0	0	4	0	0	0	5	1	4	0	15
1999	44122	Híjar	348	216	132	120	12	154	77	65	12	45	15	15	0	17	40	40	0	247	39	7	13	40
1999	44123	Hinojosa de Jarque	66	26	40	33	7	16	32	28	4	9	4	2	2	1	4	3	1	40	7	1	8	10
1999	44124	Hoz de la Vieja (La)	39	30	9	8	1	19	8	7	1	11	1	1	0	0	0	0	0	14	5	1	7	12
1999	44125	Huesa del Común	31	18	13	11	2	13	9	7	2	4	0	0	0	1	4	4	0	14	9	3	1	4
1999	44126	Iglesuela del Cid (La)	48	28	20	20	0	19	11	11	0	7	3	3	0	2	6	6	0	23	1	3	2	19
1999	44127	Jabaloyas	31	23	8	8	0	10	4	4	0	7	1	1	0	6	3	3	0	18	4	0	1	7
1999	44128	Jarque de la Val	45	11	34	34	0	10	20	20	0	0	7	7	0	1	7	7	0	36	1	2	1	4
1999	44129	Jatiel	13	9	4	4	0	7	4	4	0	1	0	0	0	1	0	0	0	9	1	0	0	3
1999	44130	Jorcas	25	22	3	3	0	12	1	1	0	5	0	0	0	5	2	2	0	12	4	0	3	6
1999	44131	Josa	7	4	3	3	0	3	3	3	0	1	0	0	0	0	0	0	0	4	0	0	1	2
1999	44132	Lagueruela	30	25	5	5	0	21	2	2	0	3	1	1	0	1	2	2	0	12	6	4	2	5
1999	44133	Lanzuela	18	15	3	1	2	14	2	0	2	1	1	1	0	0	0	0	0	9	5	1	0	3
1999	44135	Libros	101	17	84	82	2	8	61	60	1	6	8	8	0	3	15	14	1	88	3	3	2	3
1999	44136	Lidón	42	32	10	10	0	23	6	6	0	4	2	2	0	5	2	2	0	25	3	2	5	6
1999	44137	Linares de Mora	74	44	30	26	4	32	20	18	2	6	6	5	1	6	4	3	1	32	5	2	7	28
1999	44138	Loscos	75	46	29	27	2	33	20	18	2	8	3	3	0	5	6	6	0	45	7	1	5	15
1999	44141	Lledó	83	67	16	16	0	38	11	11	0	17	3	3	0	12	2	2	0	35	9	7	1	29
1999	44142	Maicas	5	5	0	0	0	4	0	0	0	1	0	0	0	0	0	0	0	0	0	2	2	1
1999	44143	Manzanera	97	46	51	45	6	37	44	40	4	5	5	3	2	4	2	2	0	54	10	3	2	28
1999	44144	Martín del Río	50	31	19	17	2	27	17	16	1	3	2	1	1	1	0	0	0	16	7	7	6	11
1999	44145	Mas de las Matas	182	126	56	52	4	105	41	38	3	15	5	4	1	6	10	10	0	133	10	12	2	25
1999	44146	Mata de los Olmos (La)	39	31	8	7	1	26	7	6	1	3	0	0	0	2	1	1	0	33	0	4	1	1
1999	44147	Mazaleón	267	202	65	57	8	131	34	30	4	41	13	11	2	30	18	16	2	100	34	19	11	102
1999	44148	Mezquita de Jarque	43	25	18	18	0	17	10	10	0	4	3	3	0	4	5	5	0	26	5	1	1	5
1999	44149	Mirambel	52	43	9	9	0	31	4	4	0	11	0	0	0	1	5	5	0	20	4	5	11	12
1999	44150	Miravete de la Sierra	22	18	4	4	0	12	4	4	0	5	0	0	0	1	0	0	0	8	2	2	6	4
1999	44151	Molinos	189	140	49	21	28	79	18	9	9	38	4	3	1	23	27	9	18	150	17	5	3	13
1999	44152	Monforte de Moyuela	60	41	19	16	3	20	12	10	2	14	3	2	1	7	4	4	0	29	7	3	0	17
1999	44153	Monreal del Campo	349	254	95	92	3	163	61	59	2	86	21	20	1	5	13	13	0	226	59	25	5	34
1999	44154	Monroyo	171	111	60	42	18	96	43	26	17	9	12	11	1	6	5	5	0	82	24	20	29	16
1999	44155	Montalbán	29	26	3	1	2	18	3	1	2	8	0	0	0	0	0	0	0	8	6	0	2	13
1999	44156	Monteagudo del Castillo	31	21	10	10	0	17	8	8	0	2	1	1	0	2	1	1	0	21	0	0	3	7
1999	44157	Monterde de Albarracín	24	18	6	5	1	11	4	4	0	6	1	1	0	1	1	0	1	12	4	0	4	4
1999	44158	Mora de Rubielos	166	84	82	82	0	65	67	67	0	4	10	10	0	15	5	5	0	125	26	6	3	4
1999	44159	Moscardón	15	12	3	3	0	8	3	3	0	4	0	0	0	0	0	0	0	4	4	1	3	3
1999	44160	Mosqueruela	176	84	92	82	10	55	59	50	9	26	23	22	1	3	10	10	0	86	16	27	8	39
1999	44161	Muniesa	309	220	89	87	2	124	50	48	2	71	12	12	0	25	27	27	0	216	38	13	4	38
1999	44163	Noguera de Albarracín	22	13	9	4	5	10	9	4	5	3	0	0	0	0	0	0	0	8	2	1	6	5
1999	44164	Nogueras	14	10	4	4	0	9	3	3	0	1	0	0	0	0	1	1	0	10	2	0	0	2
1999	44165	Nogueruelas	39	29	10	10	0	23	8	8	0	3	1	1	0	3	1	1	0	19	12	7	0	0
1999	44167	Obón	29	16	13	10	3	11	11	8	3	4	1	1	0	1	1	1	0	16	3	4	1	5
1999	44168	Odón	119	88	31	25	6	63	18	13	5	19	5	4	1	6	8	8	0	55	16	18	10	19
1999	44169	Ojos Negros	111	76	35	34	1	43	20	20	0	20	7	6	1	13	8	8	0	53	20	9	12	15
1999	44171	Olba	17	9	8	8	0	5	4	4	0	3	2	2	0	1	2	2	0	10	3	3	0	0
1999	44172	Oliete	178	145	33	30	3	133	25	25	0	4	1	1	0	8	7	4	3	147	11	2	3	13
1999	44173	Olmos (Los)	122	80	42	40	2	44	15	13	2	16	3	3	0	20	24	24	0	99	6	4	2	11
1999	44174	Orihuela del Tremedal	25	23	2	2	0	21	2	2	0	1	0	0	0	1	0	0	0	11	4	3	3	4
1999	44175	Orrios	76	36	40	39	1	18	36	35	1	14	1	1	0	4	3	3	0	43	9	2	6	16
1999	44176	Palomar de Arroyos	28	24	4	4	0	18	2	2	0	3	2	2	0	3	0	0	0	14	0	1	10	3
1999	44177	Pancrudo	68	50	18	18	0	39	13	13	0	5	2	2	0	6	3	3	0	35	9	2	5	14
1999	44178	Parras de Castellote (Las)	53	47	6	4	2	33	5	4	1	9	1	0	1	5	0	0	0	32	4	3	2	10
1999	44179	Peñarroya de Tastavins	214	158	56	45	11	113	38	30	8	32	11	8	3	13	7	7	0	93	41	14	6	59
1999	44180	Peracense	27	22	5	5	0	14	3	3	0	6	2	2	0	2	0	0	0	10	6	1	3	4
1999	44181	Peralejos	24	15	9	6	3	10	7	4	3	5	2	2	0	0	0	0	0	8	4	4	2	6
1999	44182	Perales del Alfambra	79	39	40	34	6	30	33	28	5	5	2	2	0	4	5	4	1	36	5	10	15	11
1999	44183	Pitarque	26	14	12	11	1	14	11	10	1	0	0	0	0	0	1	1	0	12	5	0	0	9
1999	44184	Plou	16	9	7	7	0	5	5	5	0	4	0	0	0	0	2	2	0	11	0	1	1	2
1999	44185	Pobo (El)	70	41	29	22	7	28	17	15	2	11	5	3	2	2	7	4	3	37	6	5	7	11
1999	44187	Portellada (La)	176	125	51	44	7	71	33	28	5	35	8	7	1	19	10	9	1	73	43	12	5	42
1999	44189	Pozondón	26	16	10	9	1	13	4	3	1	2	1	1	0	1	5	5	0	17	3	1	4	1
1999	44190	Pozuel del Campo	34	29	5	3	2	18	4	3	1	11	1	0	1	0	0	0	0	12	3	7	3	9
1999	44191	Puebla de Híjar (La)	188	125	63	57	6	107	48	42	6	12	8	8	0	6	7	7	0	119	30	7	14	13
1999	44192	Puebla de Valverde (La)	158	66	92	84	8	47	59	52	7	11	18	17	1	8	15	15	0	105	14	1	4	32
1999	44193	Puertomingalvo	66	31	35	27	8	21	16	14	2	9	11	7	4	1	8	6	2	21	7	8	1	29
1999	44194	Ráfales	104	74	30	27	3	54	27	25	2	17	2	2	0	3	1	0	1	65	14	16	4	5
1999	44195	Rillo	34	31	3	2	1	27	2	1	1	2	0	0	0	2	1	1	0	18	5	1	0	10
1999	44196	Riodeva	70	26	44	43	1	13	30	29	1	11	9	9	0	2	5	5	0	51	9	2	2	6
1999	44197	Ródenas	22	19	3	3	0	11	3	3	0	6	0	0	0	2	0	0	0	14	2	0	1	3
1999	44198	Royuela	43	32	11	8	3	19	6	4	2	11	3	3	0	2	2	1	1	19	6	2	5	11
1999	44199	Rubiales	7	3	4	4	0	2	1	1	0	1	1	1	0	0	2	2	0	3	2	0	0	2
1999	44200	Rubielos de la Cérida	16	16	0	0	0	11	0	0	0	2	0	0	0	3	0	0	0	2	2	0	0	12
1999	44201	Rubielos de Mora	56	37	19	18	1	34	17	17	0	2	2	1	1	1	0	0	0	28	15	9	2	1
1999	44203	Salcedillo	1	0	1	1	0	0	1	1	0	0	0	0	0	0	0	0	0	1	0	0	0	0
1999	44204	Saldón	13	9	4	3	1	5	1	0	1	2	3	3	0	2	0	0	0	8	1	0	1	3
1999	44205	Samper de Calanda	232	177	55	39	16	144	44	32	12	28	8	4	4	5	3	3	0	138	32	11	11	40
1999	44206	San Agustín	72	26	46	43	3	17	30	28	2	5	6	6	0	4	10	9	1	49	4	6	7	6
1999	44207	San Martín del Río	236	148	88	87	1	87	48	48	0	45	11	10	1	16	29	29	0	194	26	7	6	2
1999	44208	Santa Cruz de Nogueras	9	6	3	3	0	5	2	2	0	0	1	1	0	1	0	0	0	4	2	0	2	1
1999	44209	Santa Eulalia	184	125	59	58	1	100	38	37	1	17	7	7	0	8	14	14	0	103	15	2	17	24
1999	44210	Sarrión	265	72	193	184	9	51	130	123	7	15	21	21	0	6	42	40	2	196	18	17	8	23
1999	44211	Segura de los Baños	23	7	16	16	0	7	11	11	0	0	0	0	0	0	5	5	0	11	6	1	1	3
1999	44212	Seno	29	24	5	4	1	16	4	3	1	5	0	0	0	3	1	1	0	17	8	0	0	4
1999	44213	Singra	50	38	12	11	1	28	10	10	0	7	2	1	1	3	0	0	0	32	3	4	2	8
1999	44215	Terriente	56	38	18	16	2	20	9	7	2	13	1	1	0	5	8	8	0	42	2	1	0	10
1999	44216	Teruel	532	223	309	297	12	156	210	201	9	49	38	37	1	18	61	59	2	313	51	19	43	103
1999	44217	Toril y Masegoso	15	8	7	6	1	5	5	4	1	2	1	1	0	1	1	1	0	8	1	0	0	6
1999	44218	Tormón	3	0	3	3	0	0	3	3	0	0	0	0	0	0	0	0	0	3	0	0	0	0
1999	44219	Tornos	141	118	23	16	7	82	21	14	7	36	0	0	0	0	2	2	0	84	29	10	9	7
1999	44220	Torralba de los Sisones	81	67	14	14	0	59	11	11	0	6	3	3	0	2	0	0	0	38	9	3	5	25
1999	44221	Torrecilla de Alcañiz	133	106	27	25	2	68	18	16	2	26	4	4	0	12	5	5	0	56	21	16	6	33
1999	44222	Torrecilla del Rebollar	57	45	12	12	0	33	8	8	0	11	2	2	0	1	2	2	0	18	11	5	6	17
1999	44223	Torre de Arcas	41	26	15	9	6	23	11	6	5	2	4	3	1	1	0	0	0	21	7	1	11	1
1999	44224	Torre de las Arcas	11	10	1	1	0	10	1	1	0	0	0	0	0	0	0	0	0	7	0	0	3	1
1999	44225	Torre del Compte	102	69	33	32	1	41	12	11	1	19	9	9	0	9	12	12	0	69	12	2	3	16
1999	44226	Torrelacárcel	92	76	16	16	0	58	8	8	0	12	1	1	0	6	7	7	0	50	3	1	9	19
1999	44227	Torre los Negros	35	25	10	10	0	15	5	5	0	5	0	0	0	5	5	5	0	16	1	2	0	13
1999	44228	Torremocha de Jiloca	48	42	6	5	1	32	4	3	1	9	0	0	0	1	2	2	0	27	6	2	1	6
1999	44229	Torres de Albarracín	30	16	14	11	3	13	9	6	3	3	3	3	0	0	2	2	0	15	6	0	4	4
1999	44230	Torrevelilla	98	82	16	16	0	56	12	12	0	14	1	1	0	12	3	3	0	52	22	3	2	18
1999	44231	Torrijas	12	6	6	6	0	6	4	4	0	0	1	1	0	0	1	1	0	4	2	2	0	4
1999	44232	Torrijo del Campo	160	133	27	26	1	113	24	23	1	17	1	1	0	3	2	2	0	65	23	10	13	48
1999	44234	Tramacastiel	47	10	37	37	0	7	26	26	0	2	3	3	0	1	8	8	0	40	1	1	3	0
1999	44235	Tramacastilla	24	20	4	4	0	12	3	3	0	7	1	1	0	1	0	0	0	12	2	3	2	5
1999	44236	Tronchón	35	27	8	6	2	17	5	3	2	3	1	1	0	7	2	2	0	13	6	3	8	5
1999	44237	Urrea de Gaén	224	147	77	65	12	86	39	30	9	38	8	6	2	23	30	29	1	172	22	5	9	15
1999	44238	Utrillas	18	13	5	3	2	9	3	1	2	3	0	0	0	1	2	2	0	6	3	3	0	6
1999	44239	Valacloche	11	3	8	8	0	3	5	5	0	0	2	2	0	0	1	1	0	6	2	0	1	2
1999	44240	Valbona	44	23	21	21	0	18	17	17	0	4	2	2	0	1	2	2	0	28	4	1	1	10
1999	44241	Valdealgorfa	316	218	98	91	7	128	51	47	4	63	27	24	3	27	20	20	0	141	57	50	17	50
1999	44243	Valdecuenca	2	2	0	0	0	1	0	0	0	1	0	0	0	0	0	0	0	1	0	0	1	0
1999	44244	Valdelinares	26	19	7	3	4	14	4	1	3	3	2	1	1	2	1	1	0	4	4	1	2	15
1999	44245	Valdeltormo	84	68	16	14	2	41	9	7	2	19	3	3	0	8	4	4	0	29	12	8	5	30
1999	44246	Valderrobres	603	413	190	156	34	281	119	103	16	75	29	19	10	57	42	34	8	247	171	23	36	122
1999	44247	Valjunquera	185	129	56	49	7	75	33	29	4	35	11	10	1	19	12	10	2	83	32	23	7	40
1999	44249	Vallecillo (El)	5	4	1	1	0	1	1	1	0	1	0	0	0	2	0	0	0	4	0	0	0	1
1999	44250	Veguillas de la Sierra	9	5	4	4	0	5	2	2	0	0	0	0	0	0	2	2	0	5	0	0	0	4
1999	44251	Villafranca del Campo	106	84	22	20	2	61	14	13	1	18	7	6	1	5	1	1	0	69	9	4	2	19
1999	44252	Villahermosa del Campo	39	34	5	5	0	33	1	1	0	0	3	3	0	1	1	1	0	15	8	10	1	4
1999	44256	Villanueva del Rebollar de la Sierra	18	15	3	3	0	14	0	0	0	1	3	3	0	0	0	0	0	14	1	0	0	3
1999	44257	Villar del Cobo	44	28	16	3	13	23	7	1	6	4	5	1	4	1	4	1	3	6	5	4	7	22
1999	44258	Villar del Salz	26	18	8	8	0	8	5	5	0	4	0	0	0	6	3	3	0	17	3	1	0	5
1999	44260	Villarluengo	49	40	9	8	1	38	8	7	1	2	1	1	0	0	0	0	0	12	6	0	2	28
1999	44261	Villarquemado	224	163	61	54	7	134	39	33	6	23	7	6	1	6	15	15	0	123	14	3	46	28
1999	44262	Villarroya de los Pinares	38	21	17	16	1	19	14	14	0	1	1	1	0	1	2	1	1	14	3	1	14	5
1999	44263	Villastar	74	19	55	55	0	14	36	36	0	3	5	5	0	2	14	14	0	55	6	2	0	9
1999	44264	Villel	67	24	43	42	1	15	25	25	0	6	2	2	0	3	16	15	1	46	11	0	0	10
1999	44265	Vinaceite	82	55	27	24	3	50	24	21	3	5	2	2	0	0	1	1	0	48	15	3	2	13
1999	44266	Visiedo	92	68	24	23	1	43	14	13	1	18	1	1	0	7	9	9	0	45	11	4	8	20
1999	44267	Vivel del Río Martín	30	22	8	8	0	14	5	5	0	3	1	1	0	5	2	2	0	15	3	4	0	8
1999	44268	Zoma (La)	10	9	1	1	0	5	1	1	0	4	0	0	0	0	0	0	0	5	0	0	3	1
1999	50001	Abanto	43	34	9	8	1	24	4	4	0	9	3	2	1	1	2	2	0	17	0	2	1	23
1999	50002	Acered	183	108	75	68	7	71	32	26	6	25	14	13	1	12	29	29	0	118	19	10	5	30
1999	50003	Agón	98	47	51	50	1	26	29	28	1	10	7	7	0	11	15	15	0	83	5	5	1	4
1999	50004	Aguarón	445	217	228	208	20	173	149	133	16	25	27	26	1	19	52	49	3	335	43	12	11	30
1999	50005	Aguilón	109	79	30	27	3	59	20	20	0	13	4	2	2	7	6	5	1	80	9	2	1	13
1999	50006	Ainzón	633	276	357	347	10	158	132	126	6	47	41	39	2	71	184	182	2	554	34	11	6	25
1999	50007	Aladrén	54	29	25	24	1	22	17	16	1	5	0	0	0	2	8	8	0	47	3	1	1	2
1999	50008	Alagón	400	233	167	165	2	219	142	141	1	7	12	11	1	7	13	13	0	332	11	4	9	29
1999	50009	Alarba	107	65	42	36	6	43	23	18	5	12	5	5	0	10	14	13	1	62	17	2	7	18
1999	50010	Alberite de San Juan	58	32	26	25	1	19	8	7	1	9	4	4	0	4	14	14	0	41	7	3	2	5
1999	50011	Albeta	16	6	10	10	0	4	4	4	0	1	1	1	0	1	5	5	0	15	0	0	0	1
1999	50012	Alborge	19	11	8	6	2	6	4	3	1	3	0	0	0	2	4	3	1	11	2	0	2	2
1999	50013	Alcalá de Ebro	110	53	57	57	0	39	33	33	0	3	2	2	0	11	22	22	0	97	2	5	1	5
1999	50014	Alcalá de Moncayo	104	57	47	43	4	34	21	17	4	19	4	4	0	4	22	22	0	76	4	7	3	11
1999	50015	Alconchel de Ariza	44	39	5	5	0	29	1	1	0	7	1	1	0	3	3	3	0	10	9	6	8	11
1999	50016	Aldehuela de Liestos	27	20	7	6	1	18	6	5	1	2	0	0	0	0	1	1	0	16	2	0	3	5
1999	50017	Alfajarín	230	118	112	109	3	104	78	75	3	4	9	9	0	10	25	25	0	156	15	12	23	16
1999	50018	Alfamén	746	379	367	338	29	200	169	148	21	72	43	40	3	107	155	150	5	537	69	27	17	49
1999	50019	Alforque	19	13	6	5	1	7	4	3	1	5	0	0	0	1	2	2	0	5	4	2	3	3
1999	50020	Alhama de Aragón	80	47	33	30	3	37	22	21	1	0	1	1	0	10	10	8	2	64	5	3	2	6
1999	50021	Almochuel	21	16	5	3	2	12	4	2	2	3	0	0	0	1	1	1	0	8	4	3	3	3
1999	50022	Almolda (La)	240	157	83	79	4	143	60	57	3	7	6	5	1	7	17	17	0	164	18	18	9	30
1999	50023	Almonacid de la Cuba	140	87	53	48	5	73	33	28	5	10	7	7	0	4	13	13	0	98	21	5	11	3
1999	50024	Almonacid de la Sierra	593	312	281	274	7	211	150	144	6	51	41	40	1	50	90	90	0	508	24	8	13	35
1999	50025	Almunia de Doña Godina (La)	1671	809	862	822	40	350	320	292	28	160	91	87	4	299	451	443	8	1346	133	41	35	70
1999	50026	Alpartir	473	251	222	208	14	140	110	103	7	39	27	25	2	72	85	80	5	297	84	22	17	19
1999	50027	Ambel	288	150	138	137	1	105	93	92	1	28	7	7	0	17	38	38	0	239	18	4	1	23
1999	50028	Anento	68	30	38	38	0	14	28	28	0	9	2	2	0	7	8	8	0	54	7	2	0	3
1999	50029	Aniñón	770	445	325	319	6	234	118	113	5	159	47	47	0	52	160	159	1	572	121	24	25	27
1999	50030	Añón de Moncayo	84	50	34	34	0	29	22	22	0	13	3	3	0	8	9	9	0	67	4	1	4	6
1999	50031	Aranda de Moncayo	131	55	76	71	5	41	61	56	5	9	6	6	0	5	9	9	0	99	8	1	3	20
1999	50032	Arándiga	209	142	67	66	1	119	44	43	1	15	3	3	0	8	20	20	0	162	12	0	1	30
1999	50033	Ardisa	23	13	10	8	2	11	8	6	2	2	1	1	0	0	1	1	0	12	1	0	2	7
1999	50034	Ariza	146	97	49	47	2	77	32	30	2	8	7	7	0	12	10	10	0	76	16	14	11	26
1999	50035	Artieda	17	12	5	5	0	10	4	4	0	1	0	0	0	1	1	1	0	13	2	0	1	1
1999	50036	Asín	33	15	18	18	0	13	11	11	0	0	0	0	0	2	7	7	0	28	1	1	1	1
1999	50037	Atea	199	106	93	87	6	80	55	49	6	20	12	12	0	6	26	26	0	167	9	6	3	12
1999	50038	Ateca	487	223	264	252	12	130	110	108	2	44	30	25	5	49	124	119	5	404	39	8	1	27
1999	50039	Azuara	222	125	97	89	8	95	65	57	8	16	8	8	0	14	24	24	0	137	20	21	14	26
1999	50040	Badules	47	32	15	14	1	28	11	10	1	1	3	3	0	3	1	1	0	36	4	2	2	3
1999	50041	Bagüés	6	4	2	1	1	3	2	1	1	1	0	0	0	0	0	0	0	5	0	1	0	0
1999	50042	Balconchán	38	31	7	5	2	22	5	4	1	5	1	0	1	4	1	1	0	22	7	0	6	2
1999	50043	Bárboles	84	44	40	40	0	40	31	31	0	2	0	0	0	2	9	9	0	71	2	3	0	8
1999	50044	Bardallur	110	61	49	48	1	50	33	33	0	9	5	4	1	2	11	11	0	81	7	1	0	16
1999	50045	Belchite	751	406	345	327	18	288	186	173	13	76	45	44	1	42	114	110	4	456	139	39	22	62
1999	50046	Belmonte de Gracián	149	97	52	47	5	64	27	24	3	11	6	5	1	22	19	18	1	99	12	12	4	22
1999	50047	Berdejo	9	3	6	6	0	3	6	6	0	0	0	0	0	0	0	0	0	8	0	1	0	0
1999	50048	Berrueco	26	16	10	9	1	13	6	5	1	1	0	0	0	2	4	4	0	12	6	2	1	3
1999	50050	Bijuesca	38	24	14	14	0	18	7	7	0	1	3	3	0	5	4	4	0	24	5	0	0	7
1999	50051	Biota	278	160	118	108	10	126	74	66	8	7	8	7	1	27	36	35	1	101	65	3	20	84
1999	50052	Bisimbre	63	41	22	21	1	22	11	10	1	8	3	3	0	11	8	8	0	38	15	1	1	6
1999	50053	Boquiñeni	227	126	101	97	4	76	72	70	2	30	8	6	2	20	21	21	0	160	19	8	8	28
1999	50054	Bordalba	22	20	2	2	0	17	1	1	0	2	0	0	0	1	1	1	0	8	0	0	7	7
1999	50055	Borja	1085	527	558	546	12	319	272	262	10	102	76	75	1	106	210	209	1	847	93	37	26	74
1999	50056	Botorrita	53	41	12	12	0	31	8	8	0	7	2	2	0	3	2	2	0	32	3	1	4	10
1999	50057	Brea de Aragón	162	75	87	79	8	64	53	48	5	7	10	7	3	4	24	24	0	97	41	15	7	2
1999	50058	Bubierca	37	24	13	12	1	21	11	10	1	0	1	1	0	3	1	1	0	25	2	1	0	9
1999	50059	Bujaraloz	246	142	104	86	18	111	51	40	11	7	17	13	4	24	36	33	3	110	42	28	25	27
1999	50060	Bulbuente	198	112	86	85	1	91	53	52	1	16	8	8	0	5	25	25	0	164	14	6	5	8
1999	50061	Bureta	170	94	76	72	4	47	38	37	1	20	9	6	3	27	29	29	0	113	24	11	4	18
1999	50062	Burgo de Ebro (El)	123	69	54	51	3	57	41	39	2	7	5	5	0	5	8	7	1	84	11	1	1	21
1999	50063	Buste (El)	53	32	21	21	0	21	6	6	0	8	5	5	0	3	10	10	0	49	1	1	0	1
1999	50064	Cabañas de Ebro	122	58	64	64	0	46	43	43	0	5	1	1	0	7	20	20	0	89	15	5	1	11
1999	50065	Cabolafuente	26	22	4	4	0	16	2	2	0	2	0	0	0	4	2	2	0	8	0	7	5	5
1999	50066	Cadrete	49	30	19	19	0	21	11	11	0	7	1	1	0	2	7	7	0	41	3	0	4	1
1999	50067	Calatayud	613	321	292	288	4	258	207	203	4	30	19	19	0	33	66	66	0	503	34	10	4	60
1999	50068	Calatorao	798	410	388	367	21	254	208	191	17	85	32	32	0	71	148	144	4	630	71	17	6	52
1999	50069	Calcena	23	15	8	7	1	14	4	3	1	0	1	1	0	1	3	3	0	17	1	2	2	1
1999	50070	Calmarza	28	19	9	9	0	18	5	5	0	0	2	2	0	1	2	2	0	15	3	2	4	3
1999	50071	Campillo de Aragón	62	46	16	14	2	33	9	9	0	5	1	1	0	8	6	4	2	20	13	8	8	13
1999	50072	Carenas	58	35	23	21	2	28	12	10	2	7	1	1	0	0	10	10	0	42	4	2	1	6
1999	50073	Cariñena	869	407	462	393	69	299	323	263	60	57	45	42	3	51	94	88	6	617	85	40	21	49
1999	50074	Caspe	1400	885	515	466	49	562	366	324	42	176	52	49	3	147	97	93	4	732	270	69	41	284
1999	50075	Castejón de Alarba	75	52	23	20	3	36	15	12	3	13	2	2	0	3	6	6	0	47	6	5	4	13
1999	50076	Castejón de las Armas	48	34	14	12	2	24	11	10	1	6	1	0	1	4	2	2	0	36	8	2	0	2
1999	50077	Castejón de Valdejasa	133	79	54	49	5	75	48	43	5	2	3	3	0	2	3	3	0	106	11	2	3	11
1999	50078	Castiliscar	131	101	30	29	1	86	19	18	1	3	4	4	0	12	7	7	0	100	11	0	4	8
1999	50079	Cervera de la Cañada	234	146	88	77	11	90	52	44	8	20	6	6	0	36	30	27	3	166	19	10	16	22
1999	50080	Cerveruela	6	4	2	2	0	4	2	2	0	0	0	0	0	0	0	0	0	5	0	0	0	1
1999	50081	Cetina	82	64	18	10	8	57	17	9	8	3	0	0	0	4	1	1	0	30	7	5	4	36
1999	50082	Cimballa	47	31	16	16	0	21	13	13	0	3	0	0	0	7	3	3	0	29	10	2	1	5
1999	50083	Cinco Olivas	14	7	7	6	1	5	7	6	1	2	0	0	0	0	0	0	0	6	6	2	0	0
1999	50084	Clarés de Ribota	113	55	58	56	2	32	36	34	2	10	5	5	0	13	17	17	0	93	4	1	1	11
1999	50085	Codo	36	19	17	17	0	14	13	13	0	3	1	1	0	2	3	3	0	26	5	0	1	2
1999	50086	Codos	174	117	57	52	5	80	38	34	4	18	6	6	0	19	13	12	1	126	19	3	4	19
1999	50087	Contamina	21	13	8	8	0	11	5	5	0	1	0	0	0	1	3	3	0	15	3	0	2	1
1999	50088	Cosuenda	412	191	221	214	7	124	125	119	6	39	30	29	1	28	66	66	0	358	28	5	5	6
1999	50089	Cuarte de Huerva	16	6	10	10	0	4	8	8	0	1	0	0	0	1	2	2	0	15	1	0	0	0
1999	50090	Cubel	89	74	15	14	1	59	12	11	1	7	1	1	0	8	2	2	0	48	4	4	6	26
1999	50091	Cuerlas (Las)	42	32	10	10	0	28	9	9	0	2	0	0	0	2	1	1	0	26	3	1	4	7
1999	50092	Chiprana	53	40	13	10	3	35	10	7	3	4	3	3	0	1	0	0	0	21	6	2	10	13
1999	50093	Chodes	113	71	42	41	1	49	21	20	1	14	5	5	0	8	16	16	0	93	11	1	1	4
1999	50094	Daroca	305	183	122	115	7	157	98	92	6	11	5	5	0	15	19	18	1	250	20	7	12	10
1999	50095	Ejea de los Caballeros	1925	1222	703	619	84	851	394	325	69	144	44	43	1	227	265	251	14	996	201	130	136	428
1999	50096	Embid de Ariza	29	23	6	6	0	18	3	3	0	4	0	0	0	1	3	3	0	20	1	0	0	8
1999	50098	Encinacorba	280	146	134	130	4	93	71	67	4	26	9	9	0	27	54	54	0	223	28	8	5	10
1999	50099	Épila	1043	548	495	480	15	352	219	211	8	100	44	41	3	96	232	228	4	764	80	16	29	113
1999	50100	Erla	46	23	23	21	2	20	19	17	2	1	2	2	0	2	2	2	0	37	1	0	1	3
1999	50101	Escatrón	311	189	122	119	3	108	63	62	1	52	22	21	1	29	37	36	1	255	32	5	8	6
1999	50102	Fabara	509	397	112	91	21	226	66	51	15	104	25	22	3	67	21	18	3	194	136	21	50	107
1999	50104	Farlete	182	79	103	92	11	60	37	32	5	4	6	5	1	15	60	55	5	119	31	6	7	18
1999	50105	Fayón	195	144	51	48	3	95	27	26	1	31	13	12	1	18	11	10	1	121	38	11	8	16
1999	50106	Fayos (Los)	89	50	39	34	5	39	12	10	2	7	0	0	0	4	27	24	3	85	2	1	1	0
1999	50107	Figueruelas	164	83	81	81	0	48	43	43	0	14	2	2	0	21	36	36	0	152	5	1	2	3
1999	50108	Fombuena	5	3	2	2	0	3	2	2	0	0	0	0	0	0	0	0	0	4	0	1	0	0
1999	50109	Frago (El)	20	15	5	5	0	14	4	4	0	1	0	0	0	0	1	1	0	17	1	0	0	2
1999	50110	Frasno (El)	508	275	233	221	12	166	124	113	11	65	26	25	1	44	83	83	0	407	40	11	8	32
1999	50111	Fréscano	66	46	20	17	3	34	9	8	1	5	6	5	1	7	5	4	1	26	11	7	3	19
1999	50113	Fuendejalón	442	314	128	100	28	245	79	64	15	34	21	16	5	35	28	20	8	265	96	54	11	7
1999	50114	Fuendetodos	62	44	18	17	1	31	10	9	1	5	0	0	0	8	8	8	0	31	11	3	3	8
1999	50115	Fuentes de Ebro	645	256	389	264	125	227	309	204	105	13	22	12	10	16	58	48	10	407	118	28	30	52
1999	50116	Fuentes de Jiloca	104	72	32	28	4	53	23	20	3	10	2	2	0	9	7	6	1	61	10	1	6	26
1999	50117	Gallocanta	42	35	7	6	1	28	6	5	1	7	0	0	0	0	1	1	0	12	6	0	8	15
1999	50118	Gallur	344	213	131	126	5	175	104	99	5	23	9	9	0	15	18	18	0	253	27	13	6	40
1999	50119	Gelsa	273	202	71	67	4	156	39	37	2	27	15	14	1	19	17	16	1	172	43	40	7	9
1999	50120	Godojos	60	34	26	26	0	30	17	17	0	1	2	2	0	3	7	7	0	52	2	1	0	4
1999	50121	Gotor	178	65	113	109	4	38	72	68	4	15	12	12	0	12	29	29	0	145	14	4	1	10
1999	50122	Grisel	60	31	29	28	1	22	25	24	1	7	1	1	0	2	3	3	0	48	8	2	0	2
1999	50123	Grisén	84	41	43	43	0	28	15	15	0	4	3	3	0	9	25	25	0	78	3	1	2	0
1999	50124	Herrera de los Navarros	194	153	41	35	6	131	27	21	6	15	3	3	0	7	11	11	0	103	17	11	7	49
1999	50125	Ibdes	203	94	109	106	3	84	85	83	2	5	6	6	0	5	18	17	1	147	26	4	5	20
1999	50126	Illueca	343	90	253	250	3	62	182	179	3	10	23	23	0	18	48	48	0	300	32	3	3	5
1999	50128	Isuerre	24	19	5	4	1	17	3	3	0	0	0	0	0	2	2	1	1	19	0	0	4	1
1999	50129	Jaraba	53	23	30	28	2	17	24	24	0	2	1	1	0	4	5	3	2	41	2	1	1	7
1999	50130	Jarque de Moncayo	364	227	137	130	7	138	57	56	1	57	21	19	2	32	59	55	4	218	70	23	34	17
1999	50131	Jaulín	51	32	19	17	2	24	10	9	1	4	5	4	1	4	4	4	0	21	10	4	2	14
1999	50132	Joyosa (La)	52	32	20	18	2	26	13	11	2	3	6	6	0	3	1	1	0	34	3	7	1	7
1999	50133	Lagata	44	30	14	12	2	29	11	9	2	0	1	1	0	1	2	2	0	23	2	0	5	11
1999	50134	Langa del Castillo	106	72	34	30	4	60	27	24	3	1	3	2	1	11	4	4	0	81	3	9	2	11
1999	50135	Layana	4	4	0	0	0	4	0	0	0	0	0	0	0	0	0	0	0	0	0	0	1	2
1999	50136	Lécera	245	149	96	93	3	121	74	71	3	20	4	4	0	8	18	18	0	163	31	13	18	17
1999	50137	Leciñena	326	198	128	113	15	182	89	75	14	8	21	20	1	8	18	18	0	174	34	15	17	37
1999	50138	Lechón	17	17	0	0	0	13	0	0	0	1	0	0	0	3	0	0	0	7	4	1	3	2
1999	50139	Letux	190	109	81	78	3	81	41	38	3	21	11	11	0	7	29	29	0	141	20	3	2	16
1999	50140	Litago	71	43	28	28	0	29	19	19	0	11	4	4	0	3	5	5	0	52	5	3	8	3
1999	50141	Lituénigo	163	70	93	92	1	42	52	51	1	12	18	18	0	16	23	23	0	127	12	0	1	1
1999	50142	Lobera de Onsella	44	29	15	15	0	26	10	10	0	1	0	0	0	2	5	5	0	35	1	0	0	5
1999	50143	Longares	424	219	205	181	24	137	115	99	16	46	16	15	1	36	74	67	7	290	37	25	13	46
1999	50144	Longás	20	14	6	6	0	14	5	5	0	0	0	0	0	0	1	1	0	16	0	0	1	3
1999	50146	Lucena de Jalón	75	47	28	28	0	29	17	17	0	6	5	5	0	12	6	6	0	55	10	1	0	9
1999	50147	Luceni	177	94	83	74	9	83	50	45	5	6	11	11	0	5	22	18	4	135	11	4	4	16
1999	50148	Luesia	93	56	37	32	5	42	29	24	5	3	3	3	0	11	5	5	0	51	5	2	13	20
1999	50149	Luesma	7	7	0	0	0	7	0	0	0	0	0	0	0	0	0	0	0	0	2	0	2	3
1999	50150	Lumpiaque	254	149	105	104	1	105	64	63	1	29	16	16	0	15	25	25	0	211	13	4	15	0
1999	50151	Luna	347	213	134	118	16	204	120	104	16	3	1	1	0	6	13	13	0	218	40	8	10	68
1999	50152	Maella	994	692	302	261	41	390	162	136	26	150	57	50	7	152	83	75	8	584	139	62	46	162
1999	50153	Magallón	660	348	312	302	10	205	125	117	8	62	33	33	0	81	154	152	2	524	67	19	19	28
1999	50154	Mainar	39	30	9	7	2	26	7	5	2	0	1	1	0	4	1	1	0	20	2	5	7	5
1999	50155	Malanquilla	35	20	15	15	0	15	13	13	0	1	0	0	0	4	2	2	0	23	4	2	1	2
1999	50156	Maleján	0	0	0	0	0	0	0	0	0	0	0	0	0	0	0	0	0	0	0	0	0	0
1999	50157	Malón	201	98	103	103	0	44	40	40	0	23	2	2	0	31	61	61	0	181	12	1	1	2
1999	50159	Maluenda	365	241	124	122	2	163	79	77	2	43	7	7	0	35	38	38	0	264	40	9	18	33
1999	50160	Mallén	384	228	156	148	8	187	116	109	7	18	15	15	0	23	25	24	1	235	54	18	22	52
1999	50161	Manchones	63	43	20	19	1	41	19	18	1	0	0	0	0	2	1	1	0	44	4	4	8	2
1999	50162	Mara	130	78	52	48	4	57	32	29	3	13	9	9	0	8	11	10	1	100	9	3	4	14
1999	50163	María de Huerva	71	49	22	19	3	39	16	14	2	6	2	1	1	4	4	4	0	33	9	4	2	19
1999	50164	Mediana de Aragón	115	80	35	30	5	64	24	20	4	7	4	3	1	9	7	7	0	59	12	8	4	31
1999	50165	Mequinenza	867	592	275	229	46	303	108	80	28	179	35	29	6	110	132	120	12	375	202	122	48	116
1999	50166	Mesones de Isuela	164	85	79	72	7	64	51	45	6	14	6	6	0	7	22	21	1	105	6	1	3	49
1999	50167	Mezalocha	133	82	51	35	16	62	35	26	9	13	5	2	3	7	11	7	4	50	23	15	11	22
1999	50168	Mianos	17	14	3	2	1	12	3	2	1	1	0	0	0	1	0	0	0	9	0	1	0	7
1999	50169	Miedes de Aragón	262	176	86	84	2	115	36	35	1	31	7	6	1	30	43	43	0	161	32	4	3	62
1999	50170	Monegrillo	206	156	50	48	2	116	29	29	0	5	4	3	1	35	17	16	1	61	46	10	12	45
1999	50171	Moneva	67	29	38	34	4	24	29	26	3	3	4	3	1	2	5	5	0	38	10	2	5	10
1999	50172	Monreal de Ariza	91	70	21	19	2	55	8	7	1	9	3	3	0	6	10	9	1	36	15	6	10	24
1999	50173	Monterde	84	48	36	33	3	35	25	23	2	8	3	2	1	5	8	8	0	63	7	0	0	14
1999	50174	Montón	62	36	26	24	2	20	10	8	2	5	2	2	0	11	14	14	0	38	7	1	3	12
1999	50175	Morata de Jalón	596	354	242	234	8	241	111	105	6	48	23	22	1	65	108	107	1	447	64	33	7	36
1999	50176	Morata de Jiloca	143	85	58	53	5	53	34	29	5	21	6	6	0	11	18	18	0	90	22	4	5	21
1999	50177	Morés	178	92	86	84	2	76	60	59	1	9	6	6	0	7	20	19	1	159	7	2	1	5
1999	50178	Moros	356	210	146	138	8	133	81	73	8	28	10	10	0	49	55	55	0	273	31	7	7	34
1999	50179	Moyuela	102	60	42	40	2	56	23	21	2	1	4	4	0	3	15	15	0	62	16	2	12	2
1999	50180	Mozota	19	16	3	3	0	14	2	2	0	2	0	0	0	0	1	1	0	12	2	0	0	5
1999	50181	Muel	377	225	152	149	3	140	64	63	1	34	14	13	1	51	74	73	1	275	28	4	9	24
1999	50182	Muela (La)	400	215	185	177	8	114	78	72	6	44	14	14	0	57	93	91	2	314	23	10	7	30
1999	50183	Munébrega	311	130	181	160	21	83	121	105	16	32	13	12	1	15	47	43	4	208	43	26	10	21
1999	50184	Murero	68	39	29	22	7	37	24	19	5	0	2	2	0	2	3	1	2	47	10	2	5	3
1999	50185	Murillo de Gállego	46	24	22	20	2	20	19	17	2	2	1	1	0	2	2	2	0	35	5	1	0	5
1999	50186	Navardún	39	34	5	5	0	30	3	3	0	0	1	1	0	4	1	1	0	25	5	0	2	5
1999	50187	Nigüella	41	23	18	17	1	19	14	13	1	1	2	2	0	3	2	2	0	22	5	2	1	11
1999	50188	Nombrevilla	21	12	9	8	1	9	6	5	1	1	1	1	0	2	2	2	0	6	9	1	1	4
1999	50189	Nonaspe	363	253	110	97	13	170	55	46	9	63	26	22	4	20	29	29	0	238	60	16	13	35
1999	50190	Novallas	296	171	125	123	2	134	77	75	2	19	7	7	0	18	41	41	0	197	36	9	2	10
1999	50191	Novillas	263	133	130	120	10	116	96	87	9	6	17	16	1	11	17	17	0	154	36	26	20	27
1999	50192	Nuévalos	22	9	13	12	1	8	11	10	1	0	0	0	0	1	2	2	0	16	3	0	0	3
1999	50193	Nuez de Ebro	40	19	21	21	0	18	19	19	0	0	2	2	0	1	0	0	0	25	5	2	0	6
1999	50194	Olvés	107	62	45	42	3	40	24	21	3	14	6	6	0	8	15	15	0	73	11	8	3	12
1999	50195	Orcajo	68	35	33	32	1	23	20	19	1	11	5	5	0	1	8	8	0	48	6	2	0	10
1999	50196	Orera	113	59	54	52	2	36	27	26	1	15	5	5	0	8	22	21	1	97	8	2	0	6
1999	50197	Orés	71	34	37	26	11	23	21	14	7	2	1	1	0	9	15	11	4	51	5	4	6	2
1999	50198	Oseja	39	11	28	27	1	9	16	15	1	2	4	4	0	0	8	8	0	29	4	2	0	2
1999	50199	Osera de Ebro	39	26	13	13	0	22	12	12	0	1	0	0	0	3	1	1	0	31	3	3	0	2
1999	50200	Paniza	531	313	218	209	9	164	105	98	7	50	26	26	0	99	87	85	2	378	69	28	25	18
1999	50201	Paracuellos de Jiloca	235	134	101	101	0	88	61	61	0	25	9	9	0	21	31	31	0	203	15	2	1	13
1999	50202	Paracuellos de la Ribera	182	107	75	62	13	94	49	39	10	8	9	8	1	5	17	15	2	130	15	6	7	15
1999	50203	Pastriz	110	56	54	49	5	50	39	34	5	2	7	7	0	4	8	8	0	86	6	4	4	7
1999	50204	Pedrola	422	231	191	185	6	179	124	118	6	33	28	28	0	19	39	39	0	363	17	7	5	28
1999	50205	Pedrosas (Las)	28	23	5	4	1	23	1	1	0	0	3	2	1	0	1	1	0	12	4	1	1	8
1999	50206	Perdiguera	120	63	57	49	8	61	38	33	5	2	6	5	1	0	13	11	2	68	12	6	9	8
1999	50207	Piedratajada	23	14	9	8	1	13	8	7	1	0	1	1	0	1	0	0	0	10	3	1	6	2
1999	50208	Pina de Ebro	541	331	210	206	4	298	159	156	3	14	14	14	0	19	37	36	1	379	48	13	7	56
1999	50209	Pinseque	175	101	74	74	0	84	54	54	0	12	7	7	0	5	13	13	0	118	8	12	14	21
1999	50210	Pintanos (Los)	48	41	7	7	0	39	3	3	0	0	0	0	0	2	4	4	0	32	3	1	4	7
1999	50211	Plasencia de Jalón	139	73	66	65	1	45	41	40	1	18	5	5	0	10	20	20	0	108	8	3	3	15
1999	50212	Pleitas	22	15	7	7	0	12	5	5	0	3	0	0	0	0	2	2	0	14	0	0	0	6
1999	50213	Plenas	82	55	27	24	3	47	20	17	3	3	4	4	0	5	3	3	0	65	5	7	1	2
1999	50214	Pomer	3	2	1	1	0	2	1	1	0	0	0	0	0	0	0	0	0	2	0	0	0	1
1999	50215	Pozuel de Ariza	9	8	1	1	0	5	1	1	0	1	0	0	0	2	0	0	0	2	5	0	1	1
1999	50216	Pozuelo de Aragón	133	88	45	45	0	50	14	14	0	8	2	2	0	30	29	29	0	58	37	7	3	28
1999	50217	Pradilla de Ebro	143	85	58	52	6	70	42	37	5	6	7	6	1	9	9	9	0	105	12	2	5	17
1999	50218	Puebla de Albortón	71	56	15	13	2	40	8	7	1	13	3	3	0	3	4	3	1	33	6	3	12	14
1999	50219	Puebla de Alfindén (La)	73	40	33	23	10	37	29	20	9	3	2	1	1	0	2	2	0	52	6	3	7	4
1999	50220	Puendeluna	20	12	8	8	0	10	5	5	0	1	1	1	0	1	2	2	0	17	0	1	2	0
1999	50221	Purujosa	5	1	4	4	0	1	4	4	0	0	0	0	0	0	0	0	0	4	1	0	0	0
1999	50222	Quinto	284	186	98	90	8	168	84	76	8	8	8	8	0	10	6	6	0	184	7	21	22	41
1999	50223	Remolinos	132	70	62	56	6	50	39	33	6	10	7	7	0	10	16	16	0	93	15	11	6	5
1999	50224	Retascón	58	33	25	25	0	27	13	13	0	3	4	4	0	3	8	8	0	41	3	1	5	6
1999	50225	Ricla	927	582	345	338	7	354	141	135	6	101	40	39	1	127	164	164	0	676	85	14	20	96
1999	50227	Romanos	35	30	5	4	1	30	5	4	1	0	0	0	0	0	0	0	0	30	3	1	1	0
1999	50228	Rueda de Jalón	301	178	123	114	9	105	63	56	7	38	15	14	1	35	45	44	1	214	29	19	9	23
1999	50229	Ruesca	47	27	20	20	0	18	9	9	0	1	1	1	0	8	10	10	0	32	5	3	0	7
1999	50230	Sádaba	273	169	104	95	9	144	78	70	8	7	6	6	0	18	20	19	1	149	30	9	16	53
1999	50231	Salillas de Jalón	52	26	26	24	2	21	15	13	2	2	1	1	0	3	10	10	0	36	5	6	0	3
1999	50232	Salvatierra de Esca	37	33	4	4	0	29	2	2	0	2	0	0	0	2	2	2	0	26	0	0	3	7
1999	50233	Samper del Salz	19	10	9	9	0	8	4	4	0	2	2	2	0	0	3	3	0	16	0	0	0	1
1999	50234	San Martín de la Virgen de Moncayo	28	16	12	10	2	13	9	8	1	1	3	2	1	2	0	0	0	18	4	0	3	2
1999	50235	San Mateo de Gállego	254	144	110	96	14	135	64	56	8	5	9	9	0	4	37	31	6	168	25	15	5	36
1999	50236	Santa Cruz de Grío	207	112	95	91	4	58	48	44	4	29	14	14	0	25	33	33	0	167	21	2	7	9
1999	50237	Santa Cruz de Moncayo	55	30	25	24	1	23	15	15	0	4	3	3	0	3	7	6	1	40	8	1	1	3
1999	50238	Santa Eulalia de Gállego	28	14	14	13	1	11	12	11	1	1	0	0	0	2	2	2	0	19	3	2	1	3
1999	50239	Santed	34	22	12	6	6	17	5	0	5	5	1	0	1	0	6	6	0	17	6	5	1	5
1999	50240	Sástago	330	172	158	134	24	137	84	64	20	19	34	31	3	16	40	39	1	203	50	36	13	25
1999	50241	Saviñán	220	142	78	74	4	103	55	52	3	25	5	5	0	14	18	17	1	173	19	2	5	14
1999	50242	Sediles	38	23	15	13	2	22	11	9	2	1	2	2	0	0	2	2	0	20	9	1	4	4
1999	50243	Sestrica	308	165	143	140	3	109	77	75	2	31	11	11	0	25	55	54	1	226	43	15	5	17
1999	50244	Sierra de Luna	66	39	27	27	0	38	24	24	0	0	2	2	0	1	1	1	0	46	5	2	0	11
1999	50245	Sigüés	41	33	8	8	0	29	5	5	0	1	0	0	0	3	3	3	0	25	6	2	3	4
1999	50246	Sisamón	19	15	4	4	0	12	3	3	0	0	0	0	0	3	1	1	0	6	2	2	6	3
1999	50247	Sobradiel	95	62	33	33	0	57	21	21	0	2	2	2	0	3	10	10	0	67	6	4	6	12
1999	50248	Sos del Rey Católico	299	217	82	75	7	183	52	46	6	9	5	5	0	25	25	24	1	210	29	17	7	25
1999	50249	Tabuenca	363	209	154	153	1	126	59	58	1	45	14	14	0	38	81	81	0	235	41	18	3	62
1999	50250	Talamantes	18	10	8	8	0	8	5	5	0	1	1	1	0	1	2	2	0	12	0	1	2	2
1999	50251	Tarazona	1114	706	408	381	27	599	288	269	19	64	35	34	1	43	85	78	7	696	209	49	60	83
1999	50252	Tauste	1467	899	568	478	90	780	417	346	71	52	55	48	7	67	96	84	12	974	104	65	70	215
1999	50253	Terrer	174	109	65	61	4	71	34	31	3	22	4	4	0	16	27	26	1	122	14	3	2	31
1999	50254	Tierga	137	62	75	62	13	56	47	37	10	1	7	7	0	5	21	18	3	88	19	4	6	19
1999	50255	Tobed	161	99	62	59	3	60	37	34	3	24	7	7	0	15	18	18	0	135	10	2	5	5
1999	50256	Torralba de los Frailes	47	37	10	10	0	28	8	8	0	7	0	0	0	2	2	2	0	21	2	0	5	19
1999	50257	Torralba de Ribota	179	110	69	55	14	73	47	38	9	29	10	5	5	8	12	12	0	149	16	3	3	6
1999	50258	Torralbilla	19	15	4	4	0	14	3	3	0	0	0	0	0	1	1	1	0	9	2	0	0	8
1999	50259	Torrehermosa	20	19	1	1	0	18	0	0	0	0	0	0	0	1	1	1	0	2	5	1	1	11
1999	50260	Torrelapaja	14	12	2	2	0	6	2	2	0	4	0	0	0	2	0	0	0	7	2	2	0	2
1999	50261	Torrellas	47	40	7	7	0	36	4	4	0	2	1	1	0	2	2	2	0	27	8	6	3	2
1999	50262	Torres de Berrellén	239	134	105	100	5	115	72	68	4	14	8	8	0	5	25	24	1	172	30	7	3	25
1999	50263	Torrijo de la Cañada	150	117	33	33	0	104	26	26	0	3	1	1	0	10	6	6	0	70	26	20	11	18
1999	50264	Tosos	181	106	75	66	9	91	54	49	5	9	6	5	1	6	15	12	3	91	44	15	5	13
1999	50265	Trasmoz	52	36	16	16	0	30	12	12	0	5	1	1	0	1	3	3	0	37	3	1	2	8
1999	50266	Trasobares	141	70	71	67	4	58	47	44	3	9	8	8	0	3	16	15	1	108	8	2	4	17
1999	50267	Uncastillo	117	72	45	42	3	61	41	38	3	1	1	1	0	10	3	3	0	59	7	0	2	46
1999	50268	Undués de Lerda	21	14	7	7	0	13	5	5	0	0	1	1	0	1	1	1	0	13	0	1	4	1
1999	50269	Urrea de Jalón	116	67	49	48	1	50	27	27	0	11	8	7	1	6	14	14	0	81	9	2	4	18
1999	50270	Urriés	26	23	3	2	1	21	1	1	0	0	0	0	0	2	2	1	1	17	4	1	0	2
1999	50271	Used	165	131	34	33	1	113	20	19	1	9	6	6	0	9	8	8	0	98	13	10	3	35
1999	50272	Utebo	148	101	47	40	7	82	31	27	4	8	4	4	0	11	12	9	3	59	23	15	8	39
1999	50273	Valdehorna	85	39	46	44	2	23	28	26	2	5	3	3	0	11	15	15	0	64	5	4	1	8
1999	50274	Val de San Martín	38	21	17	15	2	18	10	8	2	1	3	3	0	2	4	4	0	30	0	1	2	5
1999	50275	Valmadrid	33	17	16	16	0	11	11	11	0	0	1	1	0	6	4	4	0	25	3	1	0	2
1999	50276	Valpalmas	50	25	25	24	1	25	21	20	1	0	1	1	0	0	3	3	0	41	3	0	1	5
1999	50277	Valtorres	36	17	19	19	0	10	8	8	0	6	1	1	0	1	10	10	0	32	2	0	0	0
1999	50278	Velilla de Ebro	42	29	13	12	1	27	12	11	1	1	1	1	0	1	0	0	0	13	11	1	11	6
1999	50279	Velilla de Jiloca	56	31	25	25	0	22	16	16	0	3	4	4	0	6	5	5	0	39	6	1	1	9
1999	50280	Vera de Moncayo	253	146	107	104	3	82	58	57	1	25	14	12	2	39	35	35	0	185	21	14	4	16
1999	50281	Vierlas	35	19	16	16	0	13	11	11	0	3	2	2	0	3	3	3	0	24	2	2	2	2
1999	50282	Vilueña (La)	118	57	61	59	2	37	24	24	0	11	5	4	1	9	32	31	1	109	2	1	0	6
1999	50283	Villadoz	34	28	6	6	0	26	5	5	0	1	1	1	0	1	0	0	0	14	4	2	2	11
1999	50284	Villafeliche	76	51	25	23	2	32	9	8	1	11	2	2	0	8	14	13	1	32	15	3	9	17
1999	50285	Villafranca de Ebro	163	97	66	63	3	76	45	42	3	12	5	5	0	9	16	16	0	129	15	3	3	6
1999	50286	Villalba de Perejil	56	30	26	26	0	26	21	21	0	2	3	3	0	2	2	2	0	38	7	1	0	10
1999	50287	Villalengua	174	101	73	57	16	67	61	47	14	24	5	4	1	10	7	6	1	93	14	5	17	44
1999	50288	Villanueva de Gállego	192	117	75	74	1	83	53	52	1	11	3	3	0	23	19	19	0	141	14	9	4	23
1999	50289	Villanueva de Jiloca	54	42	12	12	0	38	9	9	0	1	2	2	0	3	1	1	0	40	7	2	4	1
1999	50290	Villanueva de Huerva	207	116	91	77	14	97	73	60	13	14	7	7	0	5	11	10	1	124	39	13	4	24
1999	50291	Villar de los Navarros	84	54	30	28	2	43	20	19	1	9	3	2	1	2	7	7	0	54	14	4	1	9
1999	50292	Villarreal de Huerva	36	24	12	12	0	19	7	7	0	4	1	1	0	1	4	4	0	26	4	1	2	2
1999	50293	Villarroya de la Sierra	401	256	145	131	14	176	80	68	12	48	7	6	1	32	58	57	1	299	20	6	18	56
1999	50294	Villarroya del Campo	26	18	8	7	1	16	7	6	1	2	1	1	0	0	0	0	0	13	3	2	4	2
1999	50295	Vistabella	23	12	11	11	0	7	6	6	0	4	0	0	0	1	5	5	0	20	0	1	0	1
1999	50296	Zaida (La)	87	53	34	31	3	36	23	22	1	8	4	2	2	9	7	7	0	47	16	10	3	3
1999	50297	Zaragoza	2255	804	1451	1397	54	623	1068	1025	43	93	120	115	5	88	263	257	6	1522	184	62	98	289
1999	50298	Zuera	616	395	221	201	20	320	135	115	20	24	18	18	0	51	68	68	0	399	56	18	25	92
1999	50901	Biel	47	33	14	11	3	29	12	9	3	1	0	0	0	3	2	2	0	28	5	3	6	5
1999	50902	Marracos	17	12	5	4	1	12	5	4	1	0	0	0	0	0	0	0	0	5	1	0	1	10